Ｃｏりょう	Co量	名詞
ＣｒＭｏＶけい	CrMoV系	名詞
Ｃｒこう	Cr鋼	名詞
Ｃｒとうりょう	Cr当量	名詞
Ｃｒ−も	Cr-Mo	名詞
Ｃｒも	CrMo	名詞
ＣｒもＶ	CrMoV	名詞
Ｃｒりょう	Cr量	名詞
Ｃｕりょう	Cu量	名詞
Ｃぃおん	Cｌイオン	名詞
ｐがた	p形	名詞
ｐんせつごう	pn接合	名詞
あーべるぐん	アーベル群	名詞
あいそとーぷ	アイソトープ	名詞
あきょうせきこう	亜共析鋼	名詞
あくせぷた	アクセプタ	名詞
あくちゅえーたー	アクチュエーター・ディスク	名詞
あすぺくとひ	アスペクト比	名詞
あずま	厚真	名詞
あだまーる	アダマール	名詞
あだまーるのふとうしき	アダマールの不等式	名詞
あつえんざい	圧延材	名詞
あつか	圧下	名詞
あっこん	圧痕	名詞
あっしゅくこうてい	圧縮行程	名詞
あっしゅくせい	圧縮性	名詞
あっしゅくは	圧縮波	名詞
あっせつ	圧接	名詞
あっちゃく	圧着	名詞
あつにくぶ	厚肉部	名詞
あつみつひ	圧密比	名詞
あつりょくこうばい	圧力勾配	名詞
あつりょくこうりょく	圧力抗力	名詞
あつりょくは	圧力波	名詞
あつりょくほうていしき	圧力方程式	名詞
あどばんすれしお	アドバンス・レシオ	名詞
あにーる	アニール	名詞
あふぃん	アフィン	名詞
あふぃんへんかん	アフィン変換	名詞
あぽろにうす	アポロニウス	名詞
ありんかい	亜臨界	名詞
ありんかいぶんき	亜臨界分岐	名詞
あるがん	アルガン	名詞
あるふぁりゅうし	α粒子	名詞
あるみにうむざい	アルミニウム材	名詞
あろい	アロイ	名詞
あんていかい	安定解	名詞
あんていせいかいせき	安定性解析	名詞
あんていてん	安定点	名詞
あんていへいこうてん	安定平衡点	名詞
あんてん	鞍点	名詞
あんてんほう	鞍点法	名詞
あんどうでんりつ	暗導電率	名詞
あんぺあ	A	名詞
あんぺーるのほうそく	アンペールの法則	名詞
いーた	η	名詞
いこみ	鋳込み	名詞
いこむ	鋳込む	名詞
いこん	鋳込ん	名詞
いこんで	鋳込んで	名詞
いすう	位数	名詞
いそ	ISO	名詞
いそうかく	位相角	名詞
いそうぐん	位相群	名詞
いそうこうぞう	位相構造	名詞
いそうたようたい	位相多様体	名詞
いそうどうけい	位相同形	名詞
いそないと	イソナイト	名詞
いたあつ	板厚	名詞
いたざい	板材	名詞
いちいせい	一意性	名詞
いちいてき	一意的	名詞
いちいぶんかい	一意分解	名詞
いちいぶんかいせいいき	一意分解整域	名詞
いちえねるぎー	位置エネルギー	名詞
いちえねるぎー	位置エネルギー	名詞
いちじきんじ	一次近似	名詞
いちじけつごう	一次結合	名詞
いちじげん	一次元	名詞
いちじげんてき	一次元的	名詞
いちじどうかんすう	一次導関数	名詞
いちじどくりつ	一次独立	名詞
いちしゅうき	一周期	名詞
いちべくとる	位置ベクトル	名詞
いちようかじゅう	一様荷重	名詞
いちようしゅうそく	一様収束	名詞
いちようりゅう	一様流	名詞
いちようりゅうそく	一様流速	名詞
いっかいてん	一回転	名詞
いっかかんすう	一価関数	名詞
いっしゅうき	一周期	名詞
いっしょう	一翔	名詞
いったいいちたいおう	一対一対応	名詞
いっぱんかい	一般解	名詞
いっぱんかざひょう	一般化座標	名詞
いっぱんかりょく	一般化力	名詞
いっぱんじすう	一般次数	名詞
いである	イデアル	名詞
いどうそくど	移動速度	名詞
いのべ	射延べ	名詞
いばなし	鋳放	名詞
いぷしろんきんぼう	ε-近傍	名詞
いぷしろんでるた	ε-δ	名詞
いぷしろんでるたろんぽう	ε-δ論法	名詞
いほう	異方	名詞
いほうせい	異方性	名詞
いんかんすう	陰関数	名詞
いんこねる	インコネル	名詞
いんころい	インコロイ	名詞
いんしか	因子化	名詞
いんしぐん	因子群	名詞
いんていく	インテイク	名詞
いんふろー	インフロー	名詞
いんふろーれしお	インフロー・レシオ	名詞
いんふろーれしお	インフローレシオ	名詞
いんぼりゅーと	インボリュート	名詞
うぃんち	ウィンチ	名詞
うぇーばー	Wb	名詞
うえさんかくぎょうれつ	上三角行列	名詞
うぇすとらんど	ウェストランド	名詞
うぇっじ	∧	名詞
うえにとつ	上に凸	名詞
うずありりゅう	渦あり流	名詞
うすいたざい	薄板材	名詞
うずいと	渦糸	名詞
うずいとけい	渦糸系	名詞
うずいとまく	渦糸膜	名詞
うずいとめん	渦糸面	名詞
うずかん	渦管	名詞
うずくだ	渦管	名詞
うずせん	渦線	名詞
うずそう	渦層	名詞
うずつい	渦対	名詞
うずていり	渦定理	名詞
うずど	渦度	名詞
うずどほうていしき	渦度方程式	名詞
うずなし	渦なし	名詞
うずなしりゅう	渦なし流	名詞
うずほう	渦法	名詞
うずまく	渦膜	名詞
うずめん	渦面	名詞
うずようそ	渦要素	名詞
うずりゅう	渦流	名詞
うずりょういき	渦領域	名詞
うずれつ	渦列	名詞
うずれつけい	渦列系	名詞
うずわ	渦輪	名詞
うちすべり	内滑り	名詞
うにょうげんかい	運用限界	名詞
うんどうえねるぎー	運動エネルギー	名詞
うんどうかじゅう	運動荷重	名詞
うんどうぐん	運動群	名詞
うんどうほういせん	運動包囲線	名詞
うんどうほうていしき	運動方程式	名詞
うんどうりょう	運動量	名詞
うんどうりょうりろん	運動量理論	名詞
うんようしそう	運用思想	名詞
えいきょういき	影響域	名詞
えいねんほうていしき	永年方程式	名詞
えいびんか	鋭敏化	名詞
えきそう	液相	名詞
えぬじげん	n次元	名詞
えぬじげんとーらす	n次元トーラス	名詞
えねるぎ	エネルギ	名詞
えねるぎーとうぶんぱい	エネルギー等分配	名詞
えねるぎーみつど	エネルギー密度	名詞
えねるぎーりょう	エネルギー量	名詞
えびでんす	エビデンス	名詞
えふかんすう	F関数	名詞
えぼりゅーと	エボリュート	名詞
えみっしょん	エミッション	名詞
えむじげん	m次元	名詞
えむじげんきゅうめん	m次元球面	名詞
えむじげんとーらす	m次元トーラス	名詞
えらすとまー	エラストマー	名詞
えるごーどせい	エルゴード性	名詞
えるみーと	エルミート	名詞
えるみーとえんざんし	エルミート演算子	名詞
えるみーとせき	エルミート積	名詞
えろーじょん	エロージョン	名詞
えろーじょんせい	エロージョン性	名詞
えんがい	円外	名詞
えんかんじょう	円環状	名詞
えんかんすう	円関数	名詞
えんかんめん	円環面	名詞
えんかんめん	円環面座標	名詞
えんけいうず	円形渦	名詞
えんけいうずいと	円形渦糸	名詞
えんけいか	円形渦	名詞
えんけいは	円形波	名詞
えんけいまく	円形膜	名詞
えんけいよく	円形翼	名詞
えんざい	円材	名詞
えんしゅうそくど	円周速度	名詞
えんしんじゅうすい	遠心重錘	名詞
えんすとろーむ	エンストローム	名詞
えんそさん	亜塩素酸	名詞
えんそさん	次塩素酸	名詞
えんちゅうかんすう	円柱関数	名詞
えんちょくめん	鉛直面	名詞
えんちょくめんない	鉛直面内	名詞
えんていり	円定理	名詞
えんとうざひょう	円筒座標	名詞
えんばん	円板	名詞
えんばんよく	円盤翼	名詞
えんぶんたい	円分体	名詞
えんへんこう	円偏光	名詞
えんりょういき	円領域	名詞
えんりん	円輪	名詞
おいらー	オイラー	名詞
おいらーかく	オイラー角	名詞
おうぶ	凹部	名詞
おうりょく	横力	名詞
おうりょくふしょくわれ	応力腐蝕割れ	名詞
おーあ	オーア	名詞
おおがたしけん	大型試験	名詞
おおがたしけんざい	大型試験材	名詞
おーじぇ	オージェ	名詞
おーすてないと	オーステナイト	名詞
おーすてないといき	オーステナイト域	名詞
おーすてないとか	オーステナイト化	名詞
おーすてないとけい	オーステナイト系	名詞
おーそらいず	オーソライズ	名詞
おーとろーてーしょん	オートローテーション	名詞
おくじょうがた	屋上型	名詞
おくれはかい	遅れ破壊	名詞
おしゆ	押湯	名詞
おすぷれい	オスプレイ	名詞
おすぷれいほう	オスプレイ法	名詞
おもみかんすう	重み関数	名詞
おんか	音価	名詞
おんかん	温間	名詞
おんぐ	Å	名詞
がいいんせいはんどうたい	外因性半導体	名詞
かいえんばん	開円板	名詞
かいかいろ	開回路	名詞
かいき	開基	名詞
がいきおんど	外気温度	名詞
かいきょくせん	解曲線	名詞
かいきんぼう	開近傍	名詞
かいくうかん	解空間	名詞
かいけい	解形	名詞
がいけい	概形	名詞
がいこう	外項	名詞
かいこうたん	開口端	名詞
かいこうたんほせい	開口端補正	名詞
がいざー	ガイザー	名詞
かいさき	開先	名詞
かいしゅうごう	開集合	名詞
かいしゅうごうけい	開集合系	名詞
がいせい	外声	名詞
かいせき	回折	名詞
がいせき	外積	名詞
かいせきか	解析家	名詞
かいせきかい	解析解	名詞
かいせきかんすう	解析関数	名詞
かいせききか	解析幾何	名詞
がいせきくうかん	外積空間	名詞
かいせきせつぞく	解析接続	名詞
がいせきだいすう	外積代数	名詞
かいせきりきがく	解析力学	名詞
かいせつこうし	回折格子	名詞
かいぜん	カイゼン	名詞
がいそうきょり	外挿距離	名詞
かいてんうんどう	回転運動	名詞
かいてんかく	回転角	名詞
かいてんぐん	回転群	名詞
かいてんけい	回転計	名詞
かいてんこうしき	回転公式	名詞
かいてんし	回転子	名詞
かいてんじく	回転軸	名詞
かいてんそうきょくめん	回転双曲面	名詞
かいてんばね	回転羽根	名詞
かいてんほうこう	回転方向	名詞
かいてんよく	回転翼	名詞
かいてんよくき	回転翼機	名詞
かいてんりつ	回転率	名詞
かいのこうしき	解の公式	名詞
がいびぶん	外微分	名詞
かいふくいき	回復域	名詞
かいぶぶんたようたい	開部分多様体	名詞
がいぶん	外分	名詞
がいぶんてん	外分点	名詞
かいべき	開冪	名詞
かいほうくうごう	開放空盒	名詞
かいほうげん	開放弦	名詞
かいめんこうど	海面高度	名詞
かいめんじょうしょうりつ	海面上昇率	名詞
がうす	ガウス	名詞
がうすのていり	ガウスの定理	名詞
がうすのほうそく	ガウスの法則	名詞
かかい	可解	名詞
かかいぐん	可解群	名詞
かかいせい	可解性	名詞
かがくりょう	化学量	名詞
かかじゅう	過荷重	名詞
かかねつ	過加熱	名詞
かかんかん	可換環	名詞
かかんぐん	可換群	名詞
かぎゃくぎょうれつ	可逆行列	名詞
かきゅうき	過給器	名詞
かくうんどうりょう	角運動量	名詞
かくかそくど	角加速度	名詞
かくげん	各元	名詞
かくざいりょう	各材料	名詞
かくさんこう	拡散項	名詞
かくしけんざい	各試験材	名詞
かくじすう	各次数	名詞
かくせい	確性	名詞
かくせいせい	核生成	名詞
かくそくど	角速度	名詞
かくだ	各舵	名詞
かくだいじすう	拡大次数	名詞
かくだいたい	拡大体	名詞
かくとうせん	格闘戦	名詞
かくどさ	角度差	名詞
かくぶんれつだんめんせき	核分裂断面積	名詞
かくりつぎょうれつ	確率行列	名詞
かくりつとうけい	確率統計	名詞
かくりつりょう	確率量	名詞
かぐん	加群	名詞
かげんじょうじょ	加減乗除	名詞
かげんせん	下限線	名詞
かけんひ	科研費	名詞
かこうえんざんし	下降演算子	名詞
かこうきりゅう	下降気流	名詞
かこうそう	加工層	名詞
かこうりゅう	下降流	名詞
かさんこうり	可算公理	名詞
かじこう	過時効	名詞
かじこうなんか	過時効軟化	名詞
かじゅう	荷重	名詞
かじゅうばいすう	荷重倍数	名詞
がすりょう	ガス量	名詞
かせきぶんけい	可積分系	名詞
かそうしごと	仮想仕事	名詞
かたあたり	片当たり	名詞
かたさけい	硬さ計	名詞
かたしきしょうめい	型式証明	名詞
かたはつ	片発	名詞
かたもち	片持	名詞
かたもちしき	片持式	名詞
かたゆれ	片揺れ	名詞
かたよく	肩翼	名詞
かたよく	片翼	名詞
かたりん	片輪	名詞
かちょうはんい	可聴範囲	名詞
かつ	∩	名詞
かっくうひ	滑空比	名詞
がっぺいしゅうごう	合併集合	名詞
かつゆ	滑油	名詞
かつゆあつりょくけい	滑油圧力計	名詞
かつゆおんどけい	滑油温度計	名詞
かつゆれいきゃくき	滑油冷却器	名詞
かでんしたい	苛電子帯	名詞
かとう	可撓	名詞
かとうせい	可撓性	名詞
かねつほう	加熱法	名詞
かねつろ	加熱炉	名詞
かのにかるしゅうごう	カノニカル集合	名詞
かはんかく	下半角	名詞
かはんへいめん	下半平面	名詞
かびぶん	可微分	名詞
かびぶんどうそうしゃぞう	可微分同相写像	名詞
かぶん	可分	名詞
かへんぴっち	可変ピッチ	名詞
かへんよく	可変翼	名詞
かほうしかい	下方視界	名詞
かほうていり	加法定理	名詞
かまん	カマン	名詞
かめん	下面	名詞
かもふ	カモフ	名詞
かやく	可約	名詞
かるたん	カルタン	名詞
かるまんうず	カルマン渦	名詞
がるよく	ガル翼	名詞
がろあ	ガロア	名詞
かんがく	管楽	名詞
かんきょうせい	環境性	名詞
かんきょうよう	環境用	名詞
かんけいしき	関係式	名詞
かんげんせい	還元性	名詞
かんこうか	緩降下	名詞
かんさつち	観察値	名詞
かんさつほう	観察法	名詞
かんしょうき	緩衝器	名詞
かんしょうこうか	緩衝効果	名詞
かんしょうこうりょく	干渉抗力	名詞
かんしょうさよう	干渉作用	名詞
かんしょうさよう	緩衝作用	名詞
かんしょうじま	干渉縞	名詞
かんじょうしょう	緩上昇	名詞
かんしょくく	冠飾句	名詞
かんすうけい	関数系	名詞
かんすうち	関数値	名詞
かんせいしゅじく	慣性主軸	名詞
かんせいそく	慣性則	名詞
かんせいだえんたい	慣性楕円体	名詞
かんせいもーめんと	慣性モーメント	名詞
かんせいりょく	慣性力	名詞
かんぜんけい	完全系	名詞
かんぜんけいしき	完全形式	名詞
かんぜんたい	完全体	名詞
かんぜんだいひょうけい	完全代表系	名詞
かんぜんちょっこうけい	完全直交系	名詞
かんぜんびぶん	完全微分	名詞
かんぜんりゅうたい	完全流体	名詞
かんでら	cd	名詞
かんとーる	カントール	名詞
かんばー	カンバー	名詞
かんびせい	完備性	名詞
がんまかんすう	ガンマ関数	名詞
かんやくほうそく	簡約法則	名詞
がんゆうこう	含有鋼	名詞
かんりゅうこうか	貫流効果	名詞
かんろん	環論	名詞
きかがくてきばっくりんぐ	幾何学的バックリング	名詞
きかき	気化器	名詞
きかべくとる	幾何ベクトル	名詞
きかんすう	奇関数	名詞
ききない	機器内	名詞
きごうきん	基合金	名詞
きしゃく	稀釈	名詞
きしゅあげ	機首上げ	名詞
きしゅがわ	機首側	名詞
きしゅさげ	機首下げ	名詞
きじゅんしんどう	規準振動	名詞
きじゅんしんどうすう	規準振動数	名詞
きじゅんせん	基準線	名詞
きじゅんれつ	奇順列	名詞
きすうじ	奇数次	名詞
ぎすからー	擬スカラー	名詞
ぎすぺくとるほう	擬スペクトル法	名詞
きそう	気相	名詞
きたいけい	機体系	名詞
きたいけいじょう	機体形状	名詞
きたいこうぶ	機体後部	名詞
きたいじく	機体軸	名詞
きたいじゅうしん	機体重心	名詞
きたいぜんぶ	機体前部	名詞
きたいぶんしうんどうろん	気体分子運動論	名詞
きちかん	奇置換	名詞
きちょうごうきん	基超合金	名詞
ぎていじょう	擬定常	名詞
ぎてんそる	擬テンソル	名詞
きとう	帰投	名詞
きどうき	起動機	名詞
きねんごう	記念号	名詞
きのうざい	機能材	名詞
きはくきたい	希薄気体	名詞
きびがわ	機尾側	名詞
ぎべくとる	擬ベクトル	名詞
きほんかい	基本解	名詞
きほんきんぼうけい	基本近傍系	名詞
きほんりょう	基本量	名詞
ぎゃくいそうきょうかい	逆位相境界	名詞
ぎゃくえんざん	逆演算	名詞
ぎゃくがるよく	逆ガル翼	名詞
ぎゃくかんすう	逆関数	名詞
ぎゃくきき	逆効き	名詞
ぎゃくげん	逆元	名詞
ぎゃくしゃぞう	逆写像	名詞
ぎゃくぞう	逆像	名詞
ぎゃくそり	逆反り	名詞
ぎゃくちかん	逆置換	名詞
ぎゃくどうつうけい	逆導通形	名詞
きやくひょうげん	既約表現	名詞
ぎゃくふーりえへんかん	逆フーリエ変換	名詞
ぎゃくよー	逆ヨー	名詞
きゃすく	キャスク	名詞
きゃすくよう	キャスク用	名詞
きゃびてーしょん	キャビテーション	名詞
きゃぶれーたー	キャブレーター	名詞
きゅうか	級化	名詞
きゅうかく	球殻	名詞
きゅうきこう	吸気口	名詞
きゅうきこうてい	吸気行程	名詞
きゅうけいうず	球形渦	名詞
きゅうけいうずりょういき	球形渦領域	名詞
きゅうけいか	球形渦	名詞
きゅうざひょう	球座標	名詞
きゅうしゅうりつ	吸収律	名詞
きゅうしゅだんめんせき	吸収断面積	名詞
きゅうじょう	球状	名詞
きゅうじょうか	球状化	名詞
きゅうすうかい	級数解	名詞
きゅうすうてんかい	級数展開	名詞
きゅうすうひょうじ	級数表示	名詞
きゅうすうわ	級数和	名詞
きゅうぞう	吸蔵	名詞
きゅうのいまんかんすう	球ノイマン関数	名詞
きゅうはんけるかんすう	球ハンケル関数	名詞
きゅうべっせるかんすう	球ベッセル関数	名詞
きゅうめんきか	球面幾何	名詞
きゅうめんは	球面波	名詞
きょうえい	鏡映	名詞
きょうかいじょう	境界上	名詞
きょうかいそう	境界層	名詞
きょうかいち	境界値	名詞
きょうかいちもんだい	境界値問題	名詞
きょうかいぶ	境界部	名詞
ぎょうくつ	撓屈	名詞
ぎょうこいき	凝固域	名詞
ぎょうこざい	凝固材	名詞
きょうし	競試	名詞
きょうしざい	供試材	名詞
きょうしょう	共焦	名詞
きょうしょう	共晶	名詞
きょうしょうだえんたい	共焦楕円体	名詞
きょうしん	共振	名詞
きょうぞうへんかん	鏡像変換	名詞
きょうたいしょう	鏡対称	名詞
きょうつうしゅうごう	共通集合	名詞
きょうどひょうか	強度評価	名詞
ぎょうべくとる	行ベクトル	名詞
きょうへん	共変	名詞
きょうへんか	強変化	名詞
きょうへんてんそる	共変テンソル	名詞
きょうへんびぶん	共変微分	名詞
きょうへんへんかん	共変変換	名詞
きょうやくせんけいせい	共役線型性	名詞
きょうやくせんけいせい	共役線形性	名詞
きょうやくぶぶんぐん	共役部分群	名詞
きょうやくるい	共役類	名詞
きょうようち	許容値	名詞
ぎょうれつしき	行列式	名詞
ぎょうれつひょうじ	行列表示	名詞
きょくぎよう	曲技用	名詞
きょくけいしき	極形式	名詞
きょくげんそくど	極限速度	名詞
きょくげんてん	極限点	名詞
きょくざひょう	極座標	名詞
きょくざひょうけい	極座標系	名詞
きょくし	極子	名詞
きょくしょうち	極小値	名詞
きょくしょおうりょく	局所応力	名詞
きょくしょざひょうけい	局所座標系	名詞
きょくしょざひょうひょうじ	局所座標表示	名詞
きょくせいべくとる	極性ベクトル	名詞
きょくせんぐん	曲線群	名詞
きょくせんけい	曲線形	名詞
きょくだいいである	極大イデアル	名詞
きょくだいざひょうきんぼうけい	極大座標近傍系	名詞
きょくだいせんけいどくりつけい	極大線形独立系	名詞
きょくだいち	極大値	名詞
きょくひょうじ	極表示	名詞
きょくめんぐん	曲面群	名詞
きょくりつ	曲率	名詞
きょくりつはんけい	曲率半径	名詞
きょこん	虚根	名詞
きょじく	虚軸	名詞
きょしじょう	鋸歯状	名詞
きょしじょうは	鋸歯状波	名詞
きょすうかい	虚数解	名詞
きょぶ	虚部	名詞
きょりか	距離化	名詞
きょりかかのう	距離化可能	名詞
きょりくうかん	距離空間	名詞
きりかき	切欠	名詞
きりかきじゃっか	切欠弱化	名詞
きりすてりょう	切り捨て量	名詞
きりはなしご	切り離し後	名詞
きるど	キルド	名詞
きるひほっふ	キルヒホッフ	名詞
きれつ	き裂	名詞
きれつじょう	き裂状	名詞
きろぐらむ	kg	名詞
きんざい	金材	名詞
きんじかい	近似解	名詞
きんじていり	近似定理	名詞
きんじほうていしき	近似方程式	名詞
きんせいたい	禁制帯	名詞
きんぞくかん	金属間化合物	名詞
きんねつ	均熱	名詞
きんねつたい	均熱帯	名詞
きんぼうけい	近傍系	名詞
くうあんたいしょうせい	空間対称性	名詞
くうかんぐん	空間群	名詞
くうかんじょう	空間上	名詞
くうかんすい	空間錘	名詞
ぐうかんすう	偶関数	名詞
ぐうき	偶奇	名詞
くうきとりいれぐち	空気取り入れ口	名詞
くうきょじゅうりょう	空虚重量	名詞
くうきりきがくてき	空気力学的	名詞
くうごう	空盒	名詞
くうごうけいき	空盒計器	名詞
くうこうしてん	空格子点	名詞
ぐうじゅんれつ	偶順列	名詞
ぐうすうじ	偶数次	名詞
くうせん	空戦	名詞
ぐうちかん	偶置換	名詞
くうちゅうきゅうゆ	空中給油	名詞
くうちゅうきゅうゆき	空中給油機	名詞
くうぼう	空乏	名詞
くうぼうそう	空乏層	名詞
くうりき	空力	名詞
くうりきがくしゃ	空力学者	名詞
くうりきこうか	空力効果	名詞
くうりきだんせい	空力弾性	名詞
くうりきてき	空力的	名詞
くうりきへいきんげん	空力平均弦	名詞
くうりきへいきんよくげんちょう	空力平均翼弦長	名詞
くーろん	クーロン	人名
くーろん	C	名詞
くーろんのほうそく	\bm{F}=\frac{1}{4\pi\varepsilon_0}\frac{q_1q_2}{r^3}\bm{r}	名詞
くけいは	矩形波	名詞
くけいよく	矩形翼	名詞
くっきょくぶ	屈曲部	名詞
くった	クッタ	名詞
くったじゅうこふすきー	クッタ＝ジュウコフスキー	名詞
くったじょうけん	クッタ条件	名詞
くっとう	屈撓	名詞
くぬっせんすう	クヌッセン数	名詞
くぬんせん	クヌンセン	名詞
くぬんせんすう	クヌンセン数	名詞
くぶんてき	区分的	名詞
くらいてりあ	クライテリア	名詞
ぐらじえんと	グラジエント	名詞
くらすたーじょう	クラスター状	名詞
ぐらすまん	グラスマン	名詞
ぐらすまんきごう	グラスマン記号	名詞
ぐらすまんだいすう	グラスマン代数	名詞
くらっく	クラック	名詞
くらっど	クラッド	名詞
ぐらでぃえんと	グラディエント	名詞
ぐらふぁいと	グラファイト	名詞
ぐらむ	g	名詞
ぐらむいんし	グラム因子	名詞
くらめる	クラメル	名詞
くらめるのこうしき	クラメルの公式	名詞
くらんくじく	クランク軸	名詞
くりーぷしけん	クリープ試験	名詞
くりーぷはだん	クリープ破断	名詞
くりーぷはだんしけん	クリープ破断試験	名詞
くりーぷはだんしけんへん	クリープ破断試験片	名詞
ぐりーんかんすう	グリーン関数	名詞
くりふぉーどだいすう	クリフォード代数	名詞
くろねっかー	クロネッカー	名詞
ぐんぴょう	群表	名詞
くんまーへんかん	クンマー変換	名詞
けいかご	経過後	名詞
けいきばん	計器盤	名詞
けいけいうんどうそくど	計計運動速度	名詞
けいこくとう	警告灯	名詞
けいしゃかく	傾斜角	名詞
けいじょうこうりょく	形状抗力	名詞
けいじょうていこう	形状抵抗	名詞
けいじょうばりき	形状馬力	名詞
けいじょうへんか	形状変化	名詞
けいすう	径数	名詞
けいすうかんすう	係数関数	名詞
けいすうぎょうれつ	係数行列	名詞
けいぜんたい	系全体	名詞
けいそくしゃ	計測者	名詞
けいたいねつこう	系耐熱鋼	名詞
けいひ	径比	名詞
けいほうとう	警報灯	名詞
けいりー	ケイリー	名詞
けいりゅうおん	繋留音	名詞
けいりゅうかん	繋留環	名詞
けいりょういんし	計量因子	名詞
けいりょうせんけいくうかん	計量線形空間	名詞
けいりょうべくとるくうかん	計量ベクトル空間	名詞
けーらー	ケーラー	名詞
けーりー	ケーリー	名詞
げきりょく	撃力	名詞
けつげん	結言	名詞
けつごううず	結合渦	名詞
けつごうか	結合渦	名詞
けつごうそく	結合則	名詞
けつごうりつ	結合律	名詞
けつごうりつ	結合率	名詞
けっしょうがく	結晶学	名詞
けっしょうりゅう	結晶粒	名詞
けってしほうていしき	決定方程式	名詞
けるびん	K	名詞
けれっと	ケレット	名詞
けれっとしゃ	ケレット社	名詞
けんいんしき	牽引式	名詞
げんかいあんてい	限界安定	名詞
げんかいち	限界値	名詞
げんけいき	原型機	名詞
けんさほうほう	検査方法	名詞
けんしゅつのう	検出能	名詞
けんすいきょくせん	懸垂曲線	名詞
げんすいしんどう	減衰振動	名詞
げんすいしんどうすう	減衰振動数	名詞
げんそくはぐるま	減速歯車	名詞
げんそりょう	元素量	名詞
げんどうし	元同士	名詞
げんみつかい	厳密解	名詞
げんようざい	現用材	名詞
けんりょうせん	検量線	名詞
けんろん	圏論	名詞
こあざい	コア材	名詞
こいりんぐ	コイリング	名詞
こうえん	後縁	名詞
こうえんか	後縁渦	名詞
こうえんしっそく	後縁失速	名詞
こうかい	高階	名詞
こうかい	鋼塊	名詞
こうかいの	鋼塊の	名詞
こうかかく	降下角	名詞
こうかがた	硬化型	名詞
こうかじ	降下時	名詞
こうかじゅう	高荷重	名詞
こうかそくど	降下速度	名詞
こうかりつ	降下率	名詞
こうかんし	交換子	名詞
こうかんしぐん	交換子群	名詞
こうかんしせき	交換子積	名詞
こうかんせい	交換性	名詞
こうかんそく	交換則	名詞
こうかんりつ	交換律	名詞
こうかんりつ	交換率	名詞
こうきがた	後期型	名詞
こうきでん	光起電	名詞
こうきょうど	高強度	名詞
こうきょうどか	高強度化	名詞
こうきょうどこう	高強度鋼	名詞
こうきょうどざい	高強度材	名詞
ごうきんけい	合金系	名詞
こうくうし	航空史	名詞
こうくうよう	航空用	名詞
こうぐこう	工具鋼	名詞
こうくっせつりつ	高屈折率	名詞
こうけい	後傾	名詞
こうけいがた	後継型	名詞
こうけいひ	高径比	名詞
こうけん	後件	名詞
こうけん	光顕	名詞
こうけんぶ	後件部	名詞
こうこうかりつ	高降下率	名詞
こうこうりつか	高効率化	名詞
こうさいくるひろうしけん	高サイクル疲労試験	名詞
こうさすべり	交差すべり	名詞
こうじこう	高次項	名詞
こうしゅ	鋼種	名詞
こうしゅうき	高周期	名詞
こうしょく	孔食	名詞
こうしんがわ	後進側	名詞
こうじんせい	高靭性	名詞
こうしんどうすう	高振動数	名詞
こうしんひこう	後進飛行	名詞
こうしんぶれーど	後進ブレード	名詞
こうすう	項数	名詞
こうせい	較正	名詞
ごうせいかんすう	合成関数	名詞
こうせいざいりょう	構成材料	名詞
ごうせいしゃぞう	合成写像	名詞
こうせいたいきそくど	較正対気速度	名詞
ごうせつ	∧	名詞
ごうせつ	合接	名詞
こうぞうはかい	構造破壊	名詞
こうぞうひろう	構造疲労	名詞
こうそく	光束	名詞
こうそくいき	高速域	名詞
こうそくきりゅう	高速気流	名詞
こうそくじゅんこう	高速巡航	名詞
こうそくじょうけん	拘束条件	名詞
こうそくひこう	高速飛行	名詞
こうそくひこうちゅう	高速飛行中	名詞
こうそくふうどう	高速風洞	名詞
こうそくわれ	拘束割れ	名詞
こうたいかく	後退角	名詞
こうたいがわ	後退側	名詞
ごうたいきゅう	剛体球	名詞
こうたいきゅうすう	交代級数	名詞
こうたいぎょうれつ	交代行列	名詞
こうたいぐん	交代群	名詞
ごうたいけい	剛体系	名詞
ごうたいざひょうけい	剛体座標系	名詞
こうたいし	交代子	名詞
こうたいしき	交代式	名詞
ごうたいじく	剛体軸	名詞
こうたいしせき	交代子積	名詞
こうたいしょくせい	高耐食性	名詞
こうたいせい	交代性	名詞
こうたいそく	交代則	名詞
こうたいだいすう	交代代数	名詞
こうたいてき	交代的	名詞
ごうたいへき	剛体壁	名詞
ごうたいめん	剛体面	名詞
こうたいりつ	交代律	名詞
こうたん	後端	名詞
こうたんぶ	後端部	名詞
こうちゃくそうち	降着装置	名詞
こうちゅう	鋼中	名詞
こうつうりゅう	交通流	名詞
こうていあつ	高低圧	名詞
ごうてき	剛的	名詞
こうでんりょく	抗電力	名詞
こうとう	恒等	名詞
こうとうしゃぞう	恒等写像	名詞
こうとうちかん	恒等置換	名詞
こうとうてき	恒等的	名詞
こうどうでん	光導電	名詞
こうとうへんかん	恒等変換	名詞
ごうどうへんかんぐん	合同変換群	名詞
こうどさ	硬度差	名詞
こうぶ	口部	名詞
こうふか	高負荷	名詞
こうふくてん	降伏点	名詞
こうぶんかいのう	高分解能	名詞
こうべつ	項別	名詞
こうへん	鋼片	名詞
こうほうしかい	後方視界	名詞
こうほうろーたー	後方ローター	名詞
こうほざい	候補材	名詞
こうほざいりょう	候補材料	名詞
こうめん	後面	名詞
こうよく	高翼	名詞
こうりゅう	後流	名詞
こうりゅううず	後流渦	名詞
こうりゅうか	後流渦	名詞
こうりゅうかいせき	後流解析	名詞
こうりゅうかく	後流角	名詞
ごうりゅうがた	合流型	名詞
ごうりゅうがたちょうきかかんすう	合流型超幾何関数	名詞
こうりゅうそくど	後流速度	名詞
こうりゅうちゅう	後流中	名詞
こうりょうし	光量子	名詞
こうろ	光路	名詞
こうろさ	光路差	名詞
こうろちょう	光路長	名詞
こえき	固液	名詞
こーしーしゅばるつ	コーシー・シュバルツ	名詞
こーしーしゅばるつ	コーシー＝シュバルツ	名詞
こーしーれつ	コーシー列	名詞
こーにんぐかく	コーニング角	名詞
ごか	五価	名詞
こがたじく	小型軸	名詞
こがたしけん	小型試験	名詞
こがたしけんざい	小型試験材	名詞
こがたしけんざいなみ	小型試験材並	名詞
こくいん	刻印	名詞
ごさかんすう	誤差関数	名詞
ごじほうていしき	五次方程式	名詞
ごしょう	五翔	名詞
ごじょほう	互除法	名詞
ごしんごう	誤信号	名詞
こそう	固相	名詞
こたいぶつりがく	固体物理学	名詞
こちょう	弧長	名詞
こていたい	固定体	名詞
こていよくき	固定翼機	名詞
ことなる	異なる	名詞
ごぼうせい	五芒星	名詞
こほもろじー	コホモロジー	名詞
こゆうかんすう	固有関数	名詞
こゆうくうかん	固有空間	名詞
こゆうしゅうき	固有周期	名詞
こゆうしんどうすう	固有振動数	名詞
こゆうち	固有値	名詞
こゆうちもんだい	固有値問題	名詞
こゆうべくとる	固有ベクトル	名詞
こゆうりょう	固有量	名詞
こゆうわ	固有和	名詞
こよう	固溶	名詞
こようげん	固溶限	名詞
こようど	固溶度	名詞
こりおり	コリオリ	名詞
ころーじょん	コロージョン	名詞
ころけーしょんほう	コロケーション法	名詞
こんたい	根体	名詞
こんちゅう	魂柱	名詞
こんばいんど	コンバインド	名詞
こんばいんどさいくる	コンバインドサイクル	名詞
こんぱら	コンパラ	名詞
こんぼりゅーしょん	コンボリューション	名詞
さーぼふらっぷ	サーボフラップ	名詞
さーまる	サーマル	名詞
さーまるしーるど	サーマルシールド	名詞
さーめっと	サーメット	名詞
ざいか	材化	名詞
さいかん	最簡	名詞
さいかんこうたいしき	最簡交代式	名詞
さいきゅうき	再吸気	名詞
さいくりっく	サイクリック	名詞
さいくりっく	サイクリックシステム	名詞
さいくりっくふれあ	サイクリック・フレア	名詞
さいくろいど	サイクロイド	名詞
さいくろとん	サイクロトン	名詞
さいけっしょうか	再結晶化	名詞
さいこうじ	最高次	名詞
さいさ	歳差	名詞
さいさうんどう	歳差運動	名詞
さいしょうたこうしき	最小多項式	名詞
さいしょうぶんかいたい	最小分解体	名詞
さいだいかく	最大角	名詞
さいだいやだか	最大矢高	名詞
さいていじ	最低次	名詞
さいていち	最低値	名詞
さいてきかく	最適角	名詞
さいどあーむ	サイドアーム	名詞
さいみんやく	催眠薬	名詞
さいようかい	再溶解	名詞
さいようたいかしょり	再溶体化処理	名詞
サイリスタ	さいりすた	名詞
さいりゅうか	細粒化	名詞
さきほそひ	先細比	名詞
さきほそよく	先細翼	名詞
さきゆみ	先弓	名詞
ざく	ザク	名詞
さくぐ	索具	名詞
さくずかのうすう	作図可能数	名詞
さくずかのうたい	作図可能体	名詞
ざくずかのうてん	作図可能点	名詞
ざくせい	ザク性	名詞
ざくつ	座屈	名詞
させき	差積	名詞
さちる	サチる	名詞
ざつのう	雑嚢	名詞
さどうき	作動器	名詞
さどうしき	差動式	名詞
さばーる	サバール	名詞
ざひょうきんぼう	座標近傍	名詞
ざひょうきんぼうけい	座標近傍系	名詞
ざひょうひょうじ	座標表示	名詞
ざひょうめんぐん	座標面群	名詞
さようそ	作用素	名詞
さようそろん	作用素論	名詞
さんいつかんすう	散逸関数	名詞
さんいつこう	散逸項	名詞
さんか	三価	名詞
さんがく	算額	名詞
さんかくかんすう	三角関数	名詞
さんかくぎょうれつ	三角行列	名詞
さんかくふとうしき	三角不等式	名詞
さんかくよく	三角翼	名詞
さんかぶつとう	酸化物等	名詞
さんじかくだい	三次拡大	名詞
さんじげんてき	三次元的	名詞
さんじげんは	三次元波	名詞
さんじげんよく	三次元翼	名詞
さんじげんりゅう	三次元流	名詞
さんじどうかんすう	三次導関数	名詞
さんじゅうかい	三重解	名詞
さんじゅうこん	三重根	名詞
さんじゅうせき	三重積	名詞
さんしょう	三翔	名詞
さんていち	算定値	名詞
ざんとう	残湯	名詞
ざんとうりょう	残湯量	名詞
さんらんだんめんせき	散乱断面積	名詞
さんりんしき	三輪式	名詞
じあ	次亜	名詞
じい	磁位	名詞
しーそーがた	シーソー型	名詞
しーそーしき	シーソー式	名詞
しーた	θ	名詞
じーめんす	S	名詞
じぇねらるえれくとりっく	ジェネラル・エレクトリック	名詞
じか	磁荷	名詞
じかうち	直打ち	名詞
しかくか	四角化	名詞
じかりつ	磁化率	名詞
じかんしゃくど	時間尺度	名詞
じかんていすう	時間定数	名詞
じかんはってん	時間発展	名詞
しきい	しきい	名詞
しきいち	しきい値	名詞
しきけい	式形	名詞
しきへんかん	式変換	名詞
しきへんけい	式変形	名詞
しきょうへんすう	示強変数	名詞
しきりばん	仕切板	名詞
じぐ	治具	名詞
じくうかん	時空間	名詞
じくうけ	軸受	名詞
じくじゅう	軸重	名詞
じくじょう	軸上	名詞
じくせいべくとる	軸性ベクトル	名詞
じくせいべくとる	軸性ベクトル	名詞
じくたいしょう	軸対称	名詞
じくたいしょうせい	軸対称性	名詞
じくたいしょうりゅう	軸対称流	名詞
じくばりき	軸馬力	名詞
じくりゅう	軸流	名詞
じげんくうかん	次元空間	名詞
しげんぐん	四元群	名詞
しけんご	試験後	名詞
じげんこうしき	次元公式	名詞
しけんざい	試験材	名詞
しげんすう	四元数	名詞
しげんすうたい	四元数体	名詞
しけんそくてい	試験測定	名詞
しけんひこう	試験飛行	名詞
しけんへん	試験片	名詞
しけんへんない	試験片内	名詞
じこいんだくたんす	自己インダクタンス	名詞
じこうか	次硬化	名詞
しこうかんすう	試行関数	名詞
じこうざい	時効材	名詞
じこうせい	自硬性	名詞
じこじゅんどうけい	自己準同型	名詞
じこずいはん	自己随伴	名詞
じこずいはんてき	自己随伴的	名詞
じこどうけい	自己同型	名詞
じこどうけいしゃぞう	自己同型写像	名詞
しこるすきー	シコルスキー	名詞
しこるすきーしゃ	シコルスキー社	名詞
しじたいきそくど	指示対気速度	名詞
しじとう	支持塔	名詞
しじぶ	支持部	名詞
じず	次図	名詞
しすうかんすう	指数関数	名詞
しすうせきぶんかんすう	指数積分関数	名詞
じせいざい	磁性材	名詞
しそくえんざん	四則演算	名詞
したさんかくぎょうれつ	下三角行列	名詞
したにとつ	下に凸	名詞
しちぼうせい	七芒星	名詞
じつえるみーとぎょうれつ	実エルミート行列	名詞
じっかい	実解	名詞
じつかんすう	実関数	名詞
じっけんち	実験値	名詞
じっこうち	実効値	名詞
じっこん	実根	名詞
じつじく	実軸	名詞
じつじくじょう	実軸上	名詞
じっすうかい	実数解	名詞
じっすうたい	実数体	名詞
じっすうち	実数値	名詞
じっすうれつ	実数列	名詞
じつせんけい	実線形	名詞
じつせんけいくうかん	実線形空間	名詞
しっそくかく	失速角	名詞
じっそくち	実測値	名詞
じつたいしょう	実対称	名詞
じつたいしょうぎょうれつ	実対称行列	名詞
じつちょっこうぎょうれつ	実直交行列	名詞
しつてん	質点	名詞
じつぶ	実部	名詞
じつへいめん	実平面	名詞
じつべくとる	実ベクトル	名詞
じつゆにたりぎょうれつ	実ユニタリ行列	名詞
じてんこうか	自転降下	名詞
じどうかんせいこうほうそうち	自動慣性航法装置	名詞
じはいち	字配置	名詞
じびよく	字尾翼	名詞
しふとりょう	シフト量	名詞
じめんか	地面渦	名詞
じめんこうか	地面効果	名詞
じゃいろこうか	ジャイロ効果	名詞
じゃいろすこーぷ	ジャイロスコープ	名詞
しゃえいしゃぞう	射影写像	名詞
しゃかい	射界	名詞
しゃかく	射角	名詞
しゃくどほう	尺度法	名詞
じゃくはく	弱拍	名詞
じゃくへんか	弱変化	名詞
しゃこう	斜交	名詞
しゃこうざひょう	斜交座標	名詞
しゃぞう	射像	名詞
じゃっき	弱起	名詞
じゃまー	ジャマー	名詞
じゅうおん	重音	名詞
じゅうかい	重解	名詞
しゅうかいせきぶん	周回積分	名詞
しゅうきかい	周期解	名詞
しゅうきかんすう	周期関数	名詞
しゅうきこう	周期項	名詞
しゅうきょくかじゅう	終極荷重	名詞
しゅうごうぞく	集合族	名詞
しゅうごうろん	集合論	名詞
じゅーこふすきー	ジューコフスキー	名詞
じゅうこふすきー	ジュウコフスキー	名詞
じゅうこふすきーへんかん	ジュウコフスキー変換	名詞
じゅうこん	重根	名詞
じゅうしゅ	銃手	名詞
しゅうしゅくひ	収縮比	名詞
じゅうしんせん	重心線	名詞
じゅうせきぶん	重積分	名詞
しゅうそくえん	収束円	名詞
しゅうそくはんていじょうけん	収束判定条件	名詞
じゆうたん	自由端	名詞
しゅうちゅうぶ	集中部	名詞
しゅうどう	摺動	名詞
しゅうどうせい	摺動性	名詞
しゅうびる	リュウビル	名詞
しゅうほうこう	周方向	名詞
じゅうほうせん	従法線	名詞
じゆうりゅう	自由流	名詞
じゅうりょくし	重力子	名詞
じゅーる	J	名詞
じゅうろくげんすう	十六元数	名詞
しゅかんせい	主慣性	名詞
しゅかんせいもーめんと	主慣性モーメント	名詞
しゅき	主機	名詞
しゅきゃく	主脚	名詞
しゅきれつ	主亀裂	名詞
しゅくじゅう	縮重	名詞
しゅくしょうひ	縮小比	名詞
しゅくたいせい	縮退性	名詞
しゅくたいひ	縮退比	名詞
しゅくたいりつ	縮退率	名詞
しゅけた	主桁	名詞
しゅけん	主研	名詞
しゅじくざい	主軸材	名詞
しゅじくざいりょう	主軸材料	名詞
しゅじくへんかん	主軸変換	名詞
しゅしゅ	種々	名詞
しゅじょうき	主蒸気	名詞
じゅしんひょう	受信票	名詞
しゅち	主値	名詞
しゅっせん	出銑	名詞
しゅつりょくこうてい	出力行程	名詞
しゅつるむ	シュツルム	名詞
しゅつるむりゅーびる	シュツルム=リュービル	名詞
しゅつるむりゅうびる	シュツルム＝リュウビル	名詞
しゅほうこう	主方向	名詞
しゅほうせん	主法線	名詞
しゅみれーたー	シュミレーター	名詞
しゅようかい	主要解	名詞
しゅりょうしすう	主量子数	名詞
しゅれでぃんがー	シュレディンガー	名詞
じゅんい	準位	名詞
じゅんいである	純イデアル	名詞
じゅんかいき	準開基	名詞
じゅんかいぐん	巡回群	名詞
じゅんきょすう	純虚数	名詞
しゅんじち	瞬時値	名詞
じゅんせいてき	準静的	名詞
じゅんどうけい	準同型	名詞
じゅんどうけい	準同系	名詞
しょあー	ショアー	名詞
しょういそう	商位相	名詞
しょうおん	昇温	名詞
しょうおん	昇温	名詞
じようかい	次溶解	名詞
しょうかせい	昇華性	名詞
じょうきしつ	蒸気室	名詞
しょうぎょうれつてんかい	小行列展開	名詞
しょうくうかん	商空間	名詞
しょうぐん	商群	名詞
じょうぐん	乗群	名詞
しょうげきおん	衝撃音	名詞
しょうげきち	衝撃値	名詞
しょうげきはしっそく	衝撃波失速	名詞
しょうけつ	焼結	名詞
じょうげめん	上下面	名詞
じょうけんしゅうそく	条件収束	名詞
しょうこう	小孔	名詞
じょうこう	条鋼	名詞
しょうこうえんざんし	昇降演算子	名詞
しょうこうけい	昇降計	名詞
しょうこうだ	昇降舵	名詞
じょうこん	乗根	名詞
しょうさ	昇鎖	名詞
しょうされつ	昇鎖列	名詞
しょうさんちゅう	硝酸中	名詞
じょうしき	上式	名詞
じょうじせいたい	常磁性体	名詞
しょうしゃ	哨舎	名詞
しょうしゃかく	照射角	名詞
しょうしゅうごう	商集合	名詞
しょうしゅつ	晶出	名詞
しょうじゅん	焼準	名詞
しょうじゅん	焼準	名詞
じょうしょうえんざんし	上昇演算子	名詞
じょうしょうおんけい	音型	名詞
じょうしょうおんけい	上昇音型	名詞
じょうしょうかく	上昇角	名詞
じょうしょうきりゅう	上昇気流	名詞
じょうしょうりつ	上昇率	名詞
じょうせき	慣性乗積	名詞
じょうせき	乗積	名詞
しょうたい	商体	名詞
しょうだいすう	商代数	名詞
じょうたいべくとる	状態ベクトル	名詞
じょうたいりょう	状態量	名詞
しようち	使用値	名詞
じょうちゃくほう	蒸着法	名詞
しょうていり	小定理	名詞
しょうとつこう	衝突項	名詞
しょうどん	焼鈍	名詞
しょうなり	＜	名詞
しょうなり	≦	名詞
じょうはんかく	上半角	名詞
じょうはんへいめん	上半平面	名詞
じょうびぶん	常微分	名詞
じょうびぶんほうていしき	常微分方程式	名詞
しょうふう	衝風	名詞
じょうよううんようげんかいそくど	常用運用限界速度	名詞
じょうよかん	剰余環	名詞
じょうよく	上翼	名詞
じょうよたい	剰余体	名詞
じょうよるいたい	剰余類体	名詞
じょうらんほうていしき	擾乱方程式	名詞
しょきいそう	初期位相	名詞
しょきいち	初期位置	名詞
しょきじょうたい	初期状態	名詞
しょげん	諸元	名詞
しょせき	初析	名詞
しょっとぴーにんぐ	ショットピーニング	名詞
しょとうかんすう	初等関数	名詞
しょとうきか	初等幾何	名詞
しょとうきかがく	初等幾何学	名詞
しょへんすう	諸変数	名詞
しょりざい	処理材	名詞
しょりまち	処理待ち	名詞
しょりょう	諸量	名詞
じょるだん	ジョルダン	名詞
じょれい	徐冷	名詞
しりか	シリカ	名詞
しりさいど	シリサイド	名詞
しりょうへんすう	示量変数	名詞
じれいけい	自励系	名詞
しんえん	伸延	名詞
しんかいきょくせん	伸開曲線	名詞
しんかいせん	伸開線	名詞
しんぎひょう	真偽表	名詞
しんくうのゆうでんりつ	8.85\times10^{-12}	名詞
しんくうのゆうでんりつ	真空の誘電率	名詞
しんくろぷたー	シンクロプター	名詞
しんこうはかい	進行波解	名詞
しんこうひょう	進行表	名詞
しんこうほう	浸工法	名詞
しんざい	新材	名詞
しんしょくりょう	浸食量	名詞
じんせい	靭性	名詞
じんせい	靭性	名詞
しんせいきゃりあみつど	真性キャリア密度	名詞
しんせいはんどうたい	真性半導体	名詞
じんせいめん	靭性面	名詞
しんせき	浸漬	名詞
しんたいきそくど	真対気速度	名詞
しんたん	浸炭	名詞
しんちょううず	伸長渦	名詞
しんでんか	真電荷	名詞
しんどうかい	振動解	名詞
しんどうよく	振動翼	名詞
しんにゅうがた	侵入型	名詞
しんはだんおうりょく	真破断応力	名詞
しんへいきょくせん	伸閉曲線	名詞
しんへいせん	伸閉線	名詞
すいいりつ	推移律	名詞
すいじょうきか	水蒸気下	名詞
すいしょうだま	水晶玉	名詞
すいそせい	水素性	名詞
すいそぜいか	水素脆化	名詞
すいそりょう	水素量	名詞
すいそわれ	水素割れ	名詞
すいちょくあんていばん	垂直安定板	名詞
すいちょくこうか	垂直降下	名詞
すいちょくじょうしょう	垂直上昇	名詞
すいちょくじょうしょうりつ	垂直上昇率	名詞
すいちょくぶんりょく	垂直分力	名詞
ずいはんぎょうれつ	随伴行列	名詞
すいへいあんていばん	水平安定板	名詞
すいへいぎ	水平儀	名詞
すいへいたいこう	水平対向	名詞
すいへいぶんりょく	水平分力	名詞
すいめん	錐面	名詞
すいりょうとう	水量等	名詞
すいりょくけいすう	推力係数	名詞
すいりょくせん	推力線	名詞
すいりょくばりき	推力馬力	名詞
すいりょくひ	推力比	名詞
すうがくてききのうほう	数学的帰納法	名詞
すうきゅうめん	数球面	名詞
すうくうかん	数空間	名詞
すうちかい	数値解	名詞
すうちけいさｎ	数値計算	名詞
すうちごさ	数値誤差	名詞
すーぱーくりてぃかる	スーパークリティカル	名詞
すーぱーくりてぃかるよく	スーパークリティカル翼	名詞
すうべくとる	数ベクトル	名詞
すうべくとるくうかん	数ベクトル空間	名詞
すうりょうし	数量詞	名詞
すえこみ	据込	名詞
すえこみじ	据込時	名詞
すえこみひ	据込比	名詞
すからーばい	スカラー倍	名詞
ずじ	図示	名詞
すたーえんざんし	スター演算子	名詞
すとーくす	ストークス	名詞
すとれーき	ストレーキ	名詞
すとろーはる	ストローハル	名詞
すとろーはるすう	ストローハル数	名詞
ずばん	図番	名詞
すぱんほうこう	スパン方向	名詞
すぴっとふぁいあ	スピットファイア	名詞
すぺくとるほう	スペクトル法	名詞
すぽいらー	スポイラー	名詞
すぽんそん	スポンソン	名詞
すらぐ	スラグ	名詞
すらぐけい	スラグ系	名詞
すらっと	スラット	名詞
すりっぷすとりーむ	スリップストリーム	名詞
せいあつこう	静圧口	名詞
せいあんてい	静安定	名詞
せいあんていせい	静安定性	名詞
せいいき	整域	名詞
ぜいか	脆化	名詞
ぜいかど	脆化度	名詞
せいかんすう	整関数	名詞
せいきかぐん	正規化群	名詞
せいきぎょうれつ	正規行列	名詞
せいきくうかん	正規空間	名詞
せいきすう	正奇数	名詞
せいきちょっこうきてい	正規直交基底	名詞
せいきちょっこうけい	正規直交系	名詞
せいきぶぶんぐん	正規部分群	名詞
せいぐうすう	正偶数	名詞
せいげんかじゅう	制限荷重	名詞
せいげんていり	正弦定理	名詞
せいげんぶ	正弦部	名詞
せいげんようほう	制限用法	名詞
せいさくか	製作家	名詞
せいじ	斉次	名詞
せいしきょうかい	静止境界	名詞
せいしけい	静止系	名詞
せいしざひょうけい	静止座標系	名詞
せいしじょうたい	静止状態	名詞
せいしめんたい	正四面体	名詞
せいじゅうにめんたい	正十二面体	名詞
せいじゅん	正準	名詞
せいじゅんきょうやく	正準共役	名詞
せいじゅんけい	正準形	名詞
せいじゅんほうていしき	正準方程式	名詞
せいしょう	整商	名詞
せいしりゅうたい	静止流体	名詞
せいしりゅうたいちゅう	静止流体中	名詞
せいしん	制振	名詞
せいすうかん	整数環	名詞
せいせいけい	生成系	名詞
せいせいげん	生成元	名詞
せいせいすう	正整数	名詞
ぜいせいはかい	脆性破壊	名詞
せいそくかんすう	正則関数	名詞
せいそくくうかん	正則空間	名詞
せいそくせい	正則性	名詞
せいそくてん	正則点	名詞
せいち	正値	名詞
せいち	静置	名詞
せいちせい	正値性	名詞
せいちゅう	精鋳	名詞
せいていち	正定値	名詞
せいていちかんすう	正定値関数	名詞
せいていちせい	正定値性	名詞
せいてきあんていせい	静的安定性	名詞
せいでんえねるぎー	静電エネルギー	名詞
せいどうくつ	制動沓	名詞
せいどうそうち	制動装置	名詞
せいどうほうほう	制動方法	名詞
せいにじゅうめんたい	正二十面体	名詞
せいのうかいせき	性能解析	名詞
せいはちめんたい	正八面体	名詞
せいぶんひょうか	成分評価	名詞
せいほう	正方	名詞
せいぼう	星芒	名詞
せいぼうけい	星芒形	名詞
せいぼかい	聖母会	名詞
せいよく	静翼	名詞
せいりきがくてき	静力学的	名詞
せいりゅうばん	整流板	名詞
せいれん	精錬	名詞
せいれんろない	精錬炉内	名詞
ぜーた	ζ	名詞
ぜーたかんすう	ζ関数	名詞
せきいそう	積位相	名詞
せきがいせんついびがた	赤外線追尾型	名詞
せきくうかん	積空間	名詞
せきざい	赤材	名詞
せきしゅうごう	積集合	名詞
せきしゅつりょう	析出量	名詞
せきたようたい	積多様体	名詞
せきぶんかく	積分核	名詞
せきぶんきょくせん	積分曲線	名詞
せきぶんさんかくかんすう	積分三角関数	名詞
せきぶんち	積分値	名詞
せつくうかん	接空間	名詞
せっけいしそう	設計思想	名詞
せっけいじん	設計陣	名詞
せっけいそくど	設計速度	名詞
せっけいち	設計値	名詞
せっけいようきゅうち	設計要求値	名詞
せっさくご	切削後	名詞
せっさくせい	切削性	名詞
せっしょくきか	接触幾何	名詞
せっしょくへいめん	接触平面	名詞
せっせんせいぶん	接線成分	名詞
せっせんほうこう	接線方向	名詞
せっそんは	折損刃	名詞
ぜったいしゅうそく	絶対収束	名詞
せっちそくど	接地速度	名詞
せっちゅうてん	折衷点	名詞
せつどうてんかい	摂動展開	名詞
せつへいめん	接平面	名詞
せつべくとる	接ベクトル	名詞
せつべくとるくうかん	接ベクトル空間	名詞
せつべくとるば	接ベクトル場	名詞
せつめいへんすう	説明変数	名詞
せめんたいと	セメンタイト	名詞
ぜる	ゼル	名詞
せるおーとまとん	セル・オートマトン	名詞
ぜろかい	零解	名詞
ぜろぎょうれつ	零行列	名詞
ぜろげん	零元	名詞
せんいそくど	遷移速度	名詞
せんいてん	遷移点	名詞
せんいながれ	遷移流れ	名詞
せんいようりょく	遷移揚力	名詞
せんいりゅう	遷移流	名詞
ぜんえん	前縁	名詞
ぜんえんしっそく	前縁失速	名詞
ぜんえんすらっと	前縁スラット	名詞
せんおんそく	遷音速	名詞
せんかいけい	旋回計	名詞
せんかいけいしゃけい	旋回傾斜計	名詞
せんかいじ	旋回時	名詞
せんかいしき	旋回式	名詞
せんかいせき	線回折	名詞
せんかいりつ	旋回率	名詞
せんかいりゅう	旋回流	名詞
ぜんかどうしき	全可動式	名詞
ぜんかんせつがた	全間接型	名詞
ぜんかんせつがたろーたー	全間接型ローター	名詞
ぜんきがた	前期型	名詞
ぜんきゃく	前脚	名詞
ぜんぎゃくぞう	全逆像	名詞
ぜんきゅう	全弓	名詞
ぜんぎょうれつかん	全行列環	名詞
ぜんきょくりつ	全曲率	名詞
ぜんきんきょくせん	漸近曲線	名詞
ぜんきんけい	漸近形	名詞
ぜんきんてんかい	漸近展開	名詞
ぜんきんひょうじ	漸近表示	名詞
せんけいえんざんし	線形演算子	名詞
せんけいかい	線形解	名詞
せんけいかんけい	線形関係	名詞
せんけいけいかくほう	線形計画法	名詞
せんけいけつごう	線形結合	名詞
せんけいさようそ	線形作用素	名詞
せんけいしゃぞう	線形写像	名詞
せんけいじゅうぞく	線形従属	名詞
せんけいせい	線形性	名詞
せんけいだいすう	線形代数	名詞
せんけいどくりつ	線形独立	名詞
せんけいへんかん	線形変換	名詞
せんけいりさん	線形離散	名詞
ぜんけんぶ	前件	名詞
ぜんけんぶ	前件部	名詞
せんこう	旋光	名詞
ぜんこう	全高	名詞
せんざい	線材	名詞
ぜんしゃ	全射	名詞
ぜんしゅうい	全周囲	名詞
せんじよう	戦時用	名詞
せんじょうご	洗浄後	名詞
ぜんしんかく	前進角	名詞
ぜんしんがわ	前進側	名詞
ぜんしんそくど	前進速度	名詞
ぜんしんひこう	前進飛行	名詞
ぜんしんぶれーど	前進ブレード	名詞
ぜんしんよく	前進翼	名詞
ぜんせき	前席	名詞
せんせきぶん	線積分	名詞
せんそ	線素	名詞
ぜんそくひこう	全速飛行	名詞
せんだん	剪断	名詞
せんたんうず	先端渦	名詞
せんだんおうりょく	剪断応力	名詞
せんたんか	先端渦	名詞
ぜんたんしゃ	全単射	名詞
せんたんそくど	先端速度	名詞
せんたんそくどひ	先端速度比	名詞
せんちめーとる	cm	名詞
せんてん	尖点	名詞
せんてん	撰点	名詞
せんてん	選点	名詞
せんとう	旋頭	名詞
せんとうへりこぷたー	戦闘ヘリコプター	名詞
せんねつ	潜熱	名詞
ぜんばりき	全馬力	名詞
ぜんびじゅうりょう	全備重量	名詞
ぜんびぶん	全微分	名詞
せんびよく	先尾翼	名詞
せんぼうちょう	線膨張	名詞
せんみつど	線密度	名詞
せんようそ	線要素	名詞
ぜんよく	全翼	名詞
ぜんよくき	全翼機	名詞
せんりゅう	洗流	名詞
せんりゅうかく	洗流角	名詞
そいである	素イデアル	名詞
ぞうかい	造塊	名詞
ぞうかく	造格	名詞
そうかん	層間	名詞
そうかん	装換	名詞
そうかんはくり	層間剥離	名詞
そうきゅう	奏弓	名詞
そうきゅうめん	双球面	名詞
そうきょくがた	双曲型	名詞
そうきょくせんかんすう	双曲線関数	名詞
そうきょくちゅう	双曲柱	名詞
そうきょくめん	双曲面	名詞
そうくうかん	相空間	名詞
そうごかんしょう	相互干渉	名詞
そうじけい	相似形	名詞
そうじへんかん	相似変換	名詞
そうしゃ	双射	名詞
そうじゅうりょく	操縦力	名詞
そうせんけい	双線形	名詞
そうせんけいけいしき	双線型形式	名詞
そうせんけいけいしき	双線形形式	名詞
そうせんけいせい	双線形性	名詞
ぞうそく	増速	名詞
そうたいいそう	相対位相	名詞
そうたいそくど	相対速度	名詞
そうたいふう	相対風	名詞
そうたいりゅう	相対流	名詞
そうたいりゅうそく	相対流速	名詞
そうだりょく	操舵力	名詞
そうついくうかん	双対空間	名詞
そうついせい	双対性	名詞
そうてんい	相転移	名詞
そうてんい	相転位	名詞
そうはんていり	相反定理	名詞
そうへんい	相変位	名詞
そうりゅう	層流	名詞
そうりゅうよく	層流翼	名詞
そえじ	添字	名詞
そかく	素核	名詞
そくおん	測温	名詞
そくしん	測進	名詞
そくしんひこう	測進飛行	名詞
そくてん	測点	名詞
そくどいき	速度域	名詞
そくどば	速度場	名詞
そくどぶんぷかんすう	速度分布関数	名詞
そくほう	側方	名詞
そけいざい	素形材	名詞
そげきしゅ	狙撃手	名詞
そざいひ	素材費	名詞
そしきへんか	組織変化	名詞
そせい	組成	名詞
そせいれつ	組成列	名詞
そたい	素体	名詞
そだい	粗大	名詞
そだいか	粗大化	名詞
ぞっかく	属格	名詞
そど	粗度	名詞
そとすべり	外滑り	名詞
そにん	ソニン	名詞
そみつは	粗密波	名詞
そりでぃてぃー	ソリディティー	名詞
そりゅう	粗粒	名詞
そりゅうか	粗粒化	名詞
そんしょうせい	損傷性	名詞
ぞんまーふぇるど	ゾンマーフェルド	名詞
だいいちこうしき	第一公式	名詞
だいいちしょうげん	第一象限	名詞
だいいちへんぶん	第一変分	名詞
だいいっこう	第一項	名詞
だいいっしゅ	第一種	名詞
たいかくか	対角化	名詞
たいかくけい	対角形	名詞
たいかくようそ	対角要素	名詞
たいかくわ	対角和	名詞
たいかんきょう	対環境	名詞
たいき	対気	名詞
たいきか	大気下	名詞
たいきそくど	対気速度	名詞
たいきそくどけい	対気速度計	名詞
だいきゃすと	ダイキャスト	名詞
たいくうしょうめい	耐空証明	名詞
たいくうせいきじゅん	耐空性基準	名詞
たいくうるいべつ	耐空類別	名詞
たいけい	大径	名詞
たいけいか	大径化	名詞
たいざいじかん	滞在時間	名詞
だいさん	第三	名詞
たいさんか	耐酸化	名詞
たいさんかせい	耐酸化性	名詞
だいさんこう	第三項	名詞
だいさんしゅ	第三種	名詞
だいさんしょうげん	第三象限	名詞
たいじく	体軸	名詞
たいじょう	体上	名詞
たいしょうぎょうれつ	対称行列	名詞
たいしょうぐん	対称群	名詞
たいしょうしき	対称式	名詞
たいしょうそうせんけいけいしき	対称双線型形式	名詞
たいしょうてんそる	対称テンソル	名詞
たいしょうぶぶん	対称部分	名詞
たいしょうよく	対称翼	名詞
たいしょうよくがた	対称翼型	名詞
たいしょうりつ	対称律	名詞
たいしょてん	対蹠点	名詞
たいしん	体心	名詞
たいすうかんすう	対数関数	名詞
だいすうきか	代数幾何	名詞
だいすうきょくせん	代数曲線	名詞
だいすうけい	代数系	名詞
だいすうこうぞう	代数構造	名詞
だいすうてきかくだいたい	代数的拡大体	名詞
たいすうびぶん	対数微分	名詞
たいすうらせん	対数螺旋	名詞
たいせきあたり	体積当たり	名詞
たいせきそ	体積素	名詞
たいせきぶん	体積分	名詞
たいせきようそ	体積要素	名詞
だいていり	大定理	名詞
だいなみっくいんふろー	ダイナミック・インフロー	名詞
だいなり	＞	
だいなり	≧	
だいにこう	第二項	名詞
だいにこうしき	第二公式	名詞
だいにしゅ	第二種	名詞
だいにしゅるじゃんどるたこうしき	第二種ルジャンドル多項式	名詞
だいにしょうげん	第二象限	名詞
たいねつこう	耐熱鋼	名詞
たいねんせい	耐燃性	名詞
たいひこうせい	耐飛行性	名詞
だいひょうけい	代表系	名詞
たいまもう	耐摩耗	名詞
たいまもうせい	耐摩耗性	名詞
たいまもうせい	耐摩耗性	名詞
たいゆ	耐油	名詞
たいようげんかい	耐用限界	名詞
だいよんしょうげん	第四象限	名詞
たいりゅうこう	対流項	名詞
たいりょく	耐力	名詞
たいろん	体論	名詞
だえんうず	楕円渦	名詞
だえんがた	楕円型	名詞
だえんかんすう	楕円関数	名詞
だえんかんすう	楕円積分	名詞
だえんじょう	楕円上	名詞
だえんせきぶん	楕円積分	名詞
だえんたい	楕円体	名詞
だえんちゅう	楕円柱	名詞
だえんよく	楕円翼	名詞
たか	多価	名詞
たかかんすう	多価関数	名詞
だかく	舵角	名詞
たかさかんすう	高さ関数	名詞
だきょうあん	妥協案	名詞
たきょくし	多極子	名詞
だくとじょう	ダクト状	名詞
たげんかん	多元環	名詞
たこうしきかん	多項式環	名詞
たこうしょう	多幸症	名詞
たじゅうこん	多重根	名詞
たじゅうしゃくどほう	多重尺度法	名詞
たじゅうせんけい	多重線形	名詞
たじゅうせんけいけいしき	多重線形形式	名詞
たじゅうせんけいせい	多重線形性	名詞
たじゅうせんけいだいすう	多重線形代数	名詞
たじゅうれんけつ	多重連結	名詞
たしょう	多翔	名詞
たち	多値	名詞
だっかく	奪格	名詞
だっき	脱気	名詞
だっさん	脱酸	名詞
だっさんざい	脱酸剤	名詞
だっしょう	脱硝	名詞
だっすいそ	脱水素	名詞
だつぜいか	脱脆化	名詞
だったん	脱炭	名詞
だったんほう	脱炭法	名詞
だっちゃく	脱着	名詞
だっちろーる	ダッチロール	名詞
だつりゅう	脱硫	名詞
たてあんてい	縦安定	名詞
たてべくとる	縦ベクトル	名詞
たてゆれ	縦揺れ	名詞
たはつき	多発機	名詞
だぶれっと	ダブレット	名詞
たほうたい	多胞体	名詞
だめん	舵面	名詞
たようたい	多様体	名詞
たようたいろん	多様体論	名詞
だらんべーる	ダランベール	人名
だらんべーる	ダランベール	名詞
たんいえん	単位円	名詞
たんいえんばん	単位円板	名詞
たんいかいえんばん	単位開円板	名詞
たんいげん	単位元	名詞
たんいじゅうほうせん	単位従法線	名詞
たんいしゅほうせん	単位主法線	名詞
たんいちかん	単位置換	名詞
たんいほうべくとる	単位法ベクトル	名詞
たんいんし	単因子	名詞
たんかすいそ	炭化水素	名詞
たんこう	鍛鋼	名詞
たんこういである	単項イデアル	名詞
たんこういであるかん	単項イデアル環	名詞
たんこうざい	鍛鋼材	名詞
たんしゃ	単射	名詞
たんじゅんかくだい	単純拡大	名詞
たんじゅんぐん	単純群	名詞
たんしょう	探傷	名詞
たんしょうき	探傷機	名詞
たんしょくし	探触子	名詞
たんしん	鍛伸	名詞
だんせいえねるぎー	弾性エネルギー	名詞
だんせいていすう	弾性定数	名詞
だんせいてき	弾性的	名詞
だんせいろん	弾性論	名詞
たんそう	単相	名詞
たんぞうぎょう	鍛造業	名詞
たんぞうざい	鍛造材	名詞
たんぞうじ	鍛造時	名詞
たんぞうのう	鍛造能	名詞
だんそせい	弾塑性	名詞
たんちっかぶつ	炭窒化物	名詞
たんてん	端点	名詞
たんでんか	単電荷	名詞
たんのうき	短納期	名詞
たんぶ	端部	名詞
たんふりこ	単振子	名詞
だんへん	弾片	名詞
たんまつは	端末刃	名詞
たんめん	端面	名詞
だんめんない	断面内	名詞
たんりゅう	単流	名詞
たんりょうたい	単量体	名詞
たんれん	鍛錬	名詞
たんれんけつ	単連結	名詞
たんれんひ	鍛錬比	名詞
たんれんほう	鍛錬法	名詞
ちぇびしぇふ	チェビシェフ	名詞
ちじょうかじゅう	地上荷重	名詞
ちじょうけい	地上系	名詞
ちっか	窒化	名詞
ちっかそう	窒化層	名詞
ちねつよう	地熱用	名詞
ちゃくりくしんにゅう	着陸進入	名詞
ちゃくりくそうちさげそくど	着陸装置下げ速度	名詞
ちゃくりくそうちそうさそくど	着陸装置操作速度	名詞
ちゃくりくとう	着陸灯	名詞
ちゃっかんしんにゅう	着艦進入	名詞
ちゅうあつ	中圧	名詞
ちゅうおん	中音	名詞
ちゅうかんこゆうち	中間固有値	名詞
ちゅうこうざい	鋳鋼材	名詞
ちゅうじょうしょう	柱状晶	名詞
ちゅうしょうすうがく	抽象数学	名詞
ちゅうしんか	中心化	名詞
ちゅうしんかぐん	中心化群	名詞
ちゅうしんそうとう	中心相当	名詞
ちゅうせいしそく	中性子束	名詞
ちゅうせん	中線	名詞
ちゅうぞうしょ	鋳造所	名詞
ちゅうぞうよう	鋳造用	名詞
ちゅうたん	鋳鍛	名詞
ちゅうとう	注湯	名詞
ちゅうへん	中辺	名詞
ちゅうへん	鋳片	名詞
ちゅうよく	中翼	名詞
ちょうえつてき	超越的	名詞
ちょうえつてきかくだいたい	超越的拡大体	名詞
ちょうおんぱけんさ	超音波検査	名詞
ちょうかきんしそくど	超過禁止速度	名詞
ちょうかんすう	超関数	名詞
ちょうきか	超幾何	名詞
ちょうきかかんすう	超幾何関数	名詞
ちょうきゅう	長球	名詞
ちょうきゅうめん	長球面	名詞
ちょうきゅうめんかんすう	超球面関数	名詞
ちょうきょりじゅんこう	長距離巡航	名詞
ちょうこうじゅんど	超高純度	名詞
ちょうさいち	調査位置	名詞
ちょうしつ	調質	名詞
ちょうせいたぶ	調整タブ	名詞
ちょうそくき	調速機	名詞
ちょうそせい	超塑性	名詞
ちょうちょう	超々	名詞
ちょうていこうど	超低高度	名詞
ちょうどん	調鈍	名詞
ちょうねんほうていしき	長年方程式	名詞
ちょうふくそすう	超複素数	名詞
ちょうりんかい	超臨界	名詞
ちょうりんかい	超臨界	名詞
ちょうりんかいぶんき	超臨界分岐	名詞
ちょうわかんすう	調和関数	名詞
ちょうわへいきん	調和平均	名詞
ちょくこうねつ	直後熱	名詞
ちょくせきいんし	直積因子	名詞
ちょくせきしゅうごう	直積集合	名詞
ちょくせつほう	直接法	名詞
ちょくせんぐん	直線群	名詞
ちょくせんよく	直線翼	名詞
ちょくわ	直和	名詞
ちょくわいんし	直和因子	名詞
ちょっけいひ	直径比	名詞
ちょっこうか	直交化	名詞
ちょっこうかほう	直交化法	名詞
ちょっこうかんすう	直交関数	名詞
ちょっこうかんすうけい	直交関数系	名詞
ちょっこうきてい	直交基底	名詞
ちょっこうぎょうれつ	直交行列	名詞
ちょっこうぐん	直交群	名詞
ちょっこうけい	直交系	名詞
ちょっこうざひょうけい	直交座標系	名詞
ちょっこうせい	直交性	名詞
ちょっこうたこうしき	直交多項式	名詞
ついかしよう	追加仕様	名詞
ついかぜいか	追加脆化	名詞
ついほ	追補	名詞
つぇなーだいおーど	ツェナーダイオード	名詞
つぎて	継手	名詞
つりあいおもり	釣り合い錘	名詞
つりあいせんかい	釣り合い旋回	名詞
つりぐ	吊り具	名詞
つりに	吊り荷	名詞
てぃーつ	ティーツ	名詞
ていかいてん	定回転	名詞
ていかく	定角	名詞
ていかくしゅつりょく	定格出力	名詞
ていかじゅう	低荷重	名詞
ていかじゅう	定荷重	名詞
でぃがんまかんすう	ディガンマ関数	名詞
ていぎしき	定義式	名詞
ていけん	定検	名詞
ていけんじ	定検時	名詞
ていこうど	定高度	名詞
ていこうばん	抵抗板	名詞
ていこすと	低コスト	名詞
ていこすとか	低コスト化	名詞
ていじ	低次	名詞
ていじょううんどう	定常運動	名詞
ていじょうかい	定常解	名詞
ていじょうかいてん	定常回転	名詞
ていじょうしんこうは	定常進行波	名詞
ていじょうしんこうはかい	定常進行波解	名詞
ていじょうせんかい	定常旋回	名詞
ていじょうはかい	定常波解	名詞
ていじょうひこう	定常飛行	名詞
ていじょうへんさ	定常偏差	名詞
ていじょうりゅう	定常流	名詞
ていしんぎ	定針儀	名詞
ていすうこう	定数項	名詞
でぃすくかん	ディスク間	名詞
ていせきぶん	定積分	名詞
ていそうおん	低騒音	名詞
ていそく	定速	名詞
ていそくいき	低速域	名詞
ていそくき	定速機	名詞
ていそくじ	低速時	名詞
ていそくそうち	定速装置	名詞
ていそくひこう	低速飛行	名詞
ていそくひこうじ	低速飛行時	名詞
ていそくふうどう	低速風洞	名詞
てぃっぷすぴーど	ティップ・スピード	名詞
てぃっぷすぴーど	ティップスピード	名詞
てぃっぷすぴーどれしお	ティップ・スピード・レシオ	名詞
てぃっぷろす	ティップロス	名詞
ていどうし	定動詞	名詞
ていぱー	テイパー	名詞
ていふか	低負荷	名詞
ていゆうてん	低融点	名詞
ていよく	低翼	名詞
ていらーてんかい	テイラー展開	名詞
でぃりくれ	ディリクレ	名詞
ていりゅう	低硫	名詞
ていりゅうち	停留値	名詞
てぃるとろーたー	ティルトローター	名詞
ているぶーむ	テイル・ブーム	名詞
ているろーたー	テイルローター	名詞
てーぱー	テーパー	名詞
てーぱーひ	テーパー比	名詞
でしべる	dB	名詞
てすら	T	名詞
てつき	鉄基	名詞
てつきちょうごうきん	鉄基超合金	名詞
でっどまんずかーぶ	デッドマンズ・カーブ	名詞
でっどまんずかーぶ	デッドマンズカーブ	名詞
てつりょう	鉄量	名詞
でできんと	デデキント	名詞
でるたーふぇらいと	δ-フェライト	名詞
でるたかんすう	デルタ関数	名詞
てんい	転位	名詞
てんいようりょく	転移揚力	名詞
てんかこう	添加鋼	名詞
てんかざい	添加材	名詞
でんかぶんぷ	電荷分布	名詞
でんかみつど	電荷密度	名詞
でんきそうきょくし	電気双極子	名詞
でんきりきせん	電気力線	名詞
てんぐん	点群	名詞
でんけん	電顕	名詞
でんけんしつ	電顕室	名詞
でんじしき	電磁式	名詞
でんしょく	電食	名詞
でんそく	電束	名詞
てんそくてい	点測定	名詞
てんそるせき	テンソル積	名詞
てんちぎょうれつ	転置行列	名詞
てんちょうかく	天頂角	名詞
てんでんか	点電荷	名詞
でんどらいと	デンドライト	名詞
でんねつ	伝熱	名詞
でんねつふ	電熱布	名詞
てんぱー	テンパー	名詞
てんぱーからー	テンパーカラー	名詞
でんぱんかんすう	伝播関数	名詞
でんぱんは	伝播波	名詞
てんれつ	点列	名詞
どあひんじ	ドア・ヒンジ	名詞
どうあつ	動圧	名詞
どうあんてい	動安定	名詞
どうあんていせい	動安定性	名詞
とうおんちょう	等温長	名詞
とうおんちょうじかんぜいか	等温長時間脆化	名詞
とうかくしゃぞう	等角写像	名詞
とうかくしゃぞうせい	等角写像性	名詞
とうかど	透過度	名詞
どうけいしゃぞう	同型写像	名詞
どうざい	同材	名詞
どうざいせい	同材製	名詞
どうじ	同次	名詞
どうじかんたい	同時間帯	名詞
どうしき	同式	名詞
どうじくにじゅう	同軸二重	名詞
どうじくにじゅうはんてん	同軸二重反転	名詞
どうじげん	同次元	名詞
どうじほうていしき	同次方程式	名詞
とうしゅう	等周	名詞
とうしょ	頭書	名詞
とうしょのけん	頭書の件	名詞
とうじりつ	透磁率	名詞
どうしんえんぐん	同心円群	名詞
とうすいばん	透水板	名詞
どうそうしゃぞう	同相写像	名詞
どうたいきゅう	導体球	名詞
どうたいない	胴体内	名詞
どうちかんけい	同値関係	名詞
どうちょうさ	同調査	名詞
どうてい	同定	名詞
どうてきけいかくほう	動的計画法	名詞
どうてきへいこう	動的平衡	名詞
どうてきろーるおーばー	動的ロールオーバー	名詞
どうてん	動点	名詞
どうねんせいけいすう	動粘性係数	名詞
どうねんせいりつ	動粘性率	名詞
とうほう	等方	名詞
とうほうせい	等方性	名詞
とうほうてき	等方的	名詞
とうぽてんしゃる	等ポテンシャル	名詞
とうぽてんしゃるめん	等ポテンシャル面	名詞
どうりきがくてき	動力学的	名詞
どぅるーぷすとっぷ	ドゥループ・ストップ	名詞
どえふ	°F	名詞
とーらす	トーラス	名詞
とくいてん	特異点	名詞
とくせいきょくせん	特性曲線	名詞
とくせいせん	特性線	名詞
とくせいほうていしき	特性方程式	名詞
どくりつぶんしこうぶん	独立分詞構文	名詞
どしー	℃	名詞
とつしゅうごう	凸集合	名詞
とつぶ	凸部	名詞
とっぷうかじゅう	突風荷重	名詞
とっぷうかじゅうばいすう	突風荷重倍数	名詞
とっぷうほういせん	突風包囲線	名詞
どっぷらーこうか	ドップラー効果	名詞
どひょうか	度評価	名詞
どもあぶる	ド・モアブル	名詞
ともぐらふぃほう	トモグラフィ法	名詞
どもるがん	ド・モルガン	名詞
とらいぼろじー	トライボロジー	名詞
とりがんまかんすう	トリガンマ関数	名詞
とりこみかんすう	トリコミ関数	名詞
とりつけいち	取り付け位置	名詞
とりつけかく	取付角	名詞
ないかく	内核	名詞
ないがん	内含	名詞
ないこう	内項	名詞
ないせい	内声	名詞
ないせき	内積	名詞
ないせきくうかん	内積空間	名詞
ないぶじこどうけい	内部自己同型	名詞
ないぶん	内分	名詞
ないぶんてん	内分点	名詞
なかゆみ	中弓	名詞
ながれかんすう	流れ関数	名詞
ながれこみ	流れ込み	名詞
ながれせい	流れ性	名詞
ながれば	流れ場	名詞
なせる	ナセル	名詞
ななか	七価	名詞
ななじゅうそう	七重奏	名詞
なびあすとーくす	ナビア＝ストークス	名詞
なんちゃくりく	軟着陸	名詞
にか	二価	名詞
にかい	二解	名詞
にかいじょうびぶんほうていしき	二階常微分方程式	名詞
にかいてん	二回転	名詞
にかいびぶん	二階微分	名詞
にかいびぶんほうていしき	二階微分方程式	名詞
にかく	2格	名詞
にきょくざひょう	二極座標	名詞
にくあつぶ	肉厚部	名詞
にくもり	肉盛	名詞
にこうえんざん	二項演算	名詞
にこうけいすう	二項係数	名詞
にこうていり	二項定理	名詞
にこん	二根	名詞
にじいじょう	二次以上	名詞
にじかくだい	二次拡大	名詞
にじきょくめん	二次曲面	名詞
にじきんじ	二次近似	名詞
にじげんてき	二次元的	名詞
にじげんながれ	二次元流れ	名詞
にじげんは	二次元波	名詞
にじげんよく	二次元翼	名詞
にじげんりゅう	二次元流	名詞
にじっこん	二実根	名詞
にじどうかんすう	二次導関数	名詞
にじほうていしき	二次方程式	名詞
にじゅうかい	二重解	名詞
にじゅうきょく	二重極	名詞
にじゅうこうしき	二重公式	名詞
にじゅうしゅうき	二重周期	名詞
にじゅうしゅうき	二重周期関数	名詞
にじゅうせきぶん	二重積分	名詞
にじゅうはんてん	二重反転	名詞
にじゅうれんけつ	二重連結	名詞
にじゅうわきだし	二重湧き出し	名詞
にじゅはんてん	二重反転	名詞
にしょう	二翔	名詞
にそう	二相	名詞
にち	ニ値	名詞
にめんたい	二面体	名詞
にめんたいぐん	二面体群	名詞
にゅーとん	N	名詞
にゅーとんかん	ニュートン環	名詞
にゅーとんほう	ニュートン法	名詞
によう	二葉	名詞
ねこのめ	猫の目	名詞
ねこのめこうぞう	猫の目構造	名詞
ねじりあげ	捩り上げ	名詞
ねじりさげ	捩り下げ	名詞
ねつえん	熱延	名詞
ねっかん	熱間	名詞
ねつけいさん	熱計算	名詞
ねつこうかんき	熱交換器	名詞
ねつしょりざい	熱処理材	名詞
ねつしょりじ	熱処理時	名詞
ねつしょりしけん	熱処理試験	名詞
ねつしょりりょう	熱処理量	名詞
ねつそ	熱素	名詞
ねつたんち	熱探知	名詞
ねつたんちがた	熱探知型	名詞
ねつちゅうせいし	熱中性子	名詞
ねつついびがた	熱追尾型	名詞
ねつでん	熱電	名詞
ねつでんどうほうていしき	熱伝導方程式	名詞
ねつでんへんかん	熱電変換	名詞
ねつでんへんかんざいりょう	熱電変換材料	名詞
ねつりゅう	熱流	名詞
ねんせいおうりょく	粘性応力	名詞
ねんせいこう	粘性項	名詞
ねんせいていこう	粘性抵抗	名詞
ねんせいりゅう	粘性流	名詞
ねんせいりゅうたい	粘性流体	名詞
ねんりょうりょうけい	燃料量計	名詞
のいまんかんすう	ノイマン関数	名詞
のうか	濃化	名詞
のーずあっぷ	ノーズアップ	名詞
のーずだうん	ノーズダウン	名詞
のっといこーる	≠	名詞
のべさま	延べ様	名詞
のるむ	ノルム	名詞
はＺ	HAZ	名詞
ばあいわけ	場合分け	名詞
ぱーからいじんぐ	パーカライジング	名詞
ぱーからいず	パーカライズ	名詞
ぱーしぇんけいれつ	パーシェン系列	名詞
ばーとる	バートル	名詞
ばーん	バーン	人名
ばいかいへんすう	媒介変数	名詞
ばいかんすう	陪関数	名詞
はいきがす	排気ガス	名詞
はいきこうてい	排気行程	名詞
はいきしすてむ	排気システム	名詞
はいきすいりょく	排気推力	名詞
はいきゃく	廃却	名詞
はいこう	配向	名詞
はいさ	排滓	名詞
ばいしょう	焙焼	名詞
ばいたこうしき	陪多項式	名詞
はいてん	ハイテン	名詞
はいねつ	排熱	名詞
はいぶりっと	ハイブリット	名詞
ばいぶれーた	バイブレータ	名詞
ばいほうていしき	陪方程式	名詞
ぱいろめーた	パイロメータ	名詞
はいんど	ハインド	名詞
はうすどるふ	ハウスドルフ	名詞
はうすどるふくうかん	ハウスドルフ空間	名詞
はかいきょうど	破壊強度	名詞
はきだしほう	掃き出し法	名詞
はくしょくこう	白色光	名詞
はくめ	拍目	名詞
はくよく	薄翼	名詞
はくよくしっそく	薄翼失速	名詞
はくよくりろん	薄翼理論	名詞
はくりせい	剥離性	名詞
はくりてん	剥離点	名詞
はけい	波型	名詞
はじょうてんい	刃状転位	名詞
はすう	波数	名詞
ぱすかる	Pa	名詞
ぱすかん	パス間	名詞
はすてろい	ハステロイ	名詞
はせいがた	派生型	名詞
はだん	破断	名詞
はだんいち	破断位置	名詞
はだんじかん	破断時間	名詞
はちげんすう	八元数	名詞
はちじゅうそう	八重奏	名詞
ばっくりんぐ	バックリング	名詞
はっさんていり	発散定理	名詞
はっしょう	八翔	名詞
はっせいじき	発生時期	名詞
はどうほうていしき	波動方程式	名詞
ばなっは	バナッハ	名詞
ばね	撥条	名詞
はぶすぷりんぐ	ハブ・スプリング	名詞
はみるとにあん	ハミルトニアン	名詞
はみるとん	ハミルトン	名詞
はめん	波面	名詞
はめん	破面	名詞
ばらくた	バラクタ	名詞
はらびれ	腹びれ	名詞
ばりきかじゅう	馬力荷重	名詞
ばるまーけいれつ	バルマー系列	名詞
はんかたもちしき	半片持式	名詞
はんかん	半環	名詞
はんかんすう	汎関数	名詞
はんかんせつがたろーたー	半間接型ローター	名詞
はんきすう	半奇数	名詞
はんきすうじ	半奇数次	名詞
はんぐうすう	半偶数	名詞
はんぐうすうじ	半偶数次	名詞
ばんくかく	バンク角	名詞
ばんくけい	バンク計	名詞
はんけるかんすう	ハンケル関数	名詞
はんしゃりつ	反射律	名詞
はんしんりがく	反心理学	名詞
はんたいしょう	反対称	名詞
はんたいしょうぎょうれつ	反対称行列	名詞
はんたいしょうしき	反対称式	名詞
はんたいしょうせい	反対称性	名詞
はんたいしょうてんそる	反対称テンソル	名詞
はんたいしょうぶぶん	反対称部分	名詞
はんていじょうけん	判定条件	名詞
はんとけい	反時計	名詞
はんとるく	反トルク	名詞
はんへいめん	半平面	名詞
はんべつしき	判別式	名詞
はんへん	反変	名詞
はんへんてんそる	反変テンソル	名詞
はんへんへんかん	反変変換	名詞
ばんりゅう	伴流	名詞
ひＰ	ＨＩＰ	名詞
ひＴ	ＨＩＴ	名詞
ぴあせっき	ピアセッキ	名詞
ぴあせっきしゃ	ピアセッキ社	名詞
ひあっしゅく	非圧縮	名詞
ひあっしゅくせい	非圧縮性	名詞
ひあっしゅくせいかんぜんりゅうたい	非圧縮性完全流体	名詞
ひあっしゅくりゅうたい	非圧縮流体	名詞
びーとりす	ビートリス	名詞
びおさばーる	ビオ・サバール	名詞
ひかいてん	非回転	名詞
ひかいてんけい	非回転系	名詞
ひかいてんてき	非回転的	名詞
ひかかん	非可換	名詞
ひかくざい	比較材	名詞
ひきょうど	比強度	名詞
ぴくりんさん	ピクリン酸	名詞
びけいすう	微係数	名詞
ひけっしょう	非結晶	名詞
ひこうおん	非高温	名詞
ひこうかじゅう	飛行荷重	名詞
ひこうけいろ	飛行経路	名詞
ひこうじ	飛行時	名詞
ひこうしけん	飛行試験	名詞
ひこうじょうたい	飛行状態	名詞
ひこうぜん	飛行前	名詞
ひこうちゅう	飛行中	名詞
ひしゅうき	非周期	名詞
ひしゅくたい	非縮退	名詞
ひしゅくたいせい	非縮退性	名詞
ひしゅくたいてき	非縮退的	名詞
びしょうかく	微小角	名詞
びしょうじかん	微小時間	名詞
びしょうじょうらん	微小擾乱	名詞
びしょうしんどう	微小振動	名詞
びしょうそへん	微小素片	名詞
びしょうぶぶん	微小部分	名詞
びしょうへんい	微小変位	名詞
びしょうへんか	微小変化	名詞
ひしょうもう	非消耗	名詞
びしょうようそ	微小要素	名詞
びしょうりょう	微小量	名詞
ひじょすう	被除数	名詞
ひじれいけい	非自励系	名詞
ひずみ	歪	名詞
ひずみりょう	歪量	名詞
ひせいげんようほう	非制限用法	名詞
ひせいじ	非斉次	名詞
ひせいすう	非整数	名詞
ひせいそく	非正則	名詞
ひせいていちせい	非正定値性	名詞
ひせきぶん	被積分	名詞
びせきぶんがく	微積分学	名詞
ひせきぶんかんすう	被積分関数	名詞
ひせんけいか	非線形化	名詞
ひせんけいかい	非線形解	名詞
ひせんけいけい	非線形系	名詞
ひせんけいこう	非線形項	名詞
ひせんけいこうか	非線形効果	名詞
ひたいか	非退化	名詞
ひたいかせい	非退化性	名詞
ひたいかてき	非退化的	名詞
ひたいしょうよく	非対称翼	名詞
ひたいしょうよくがた	非対称翼型	名詞
ひだりきょくげん	左極限	名詞
ひだりてけい	左手系	名詞
ひだりれいいんし	左零因子	名詞
びっかーす	ビッカース	名詞
ぴっちかく	ピッチ角	名詞
ぴっちんぐ	ピッチング	名詞
ひっぱり	引張	名詞
ひっぱりのび	引張伸び	名詞
ひていし	否定詞	名詞
ひていじょう	非定常	名詞
ひていじょうかい	非定常解	名詞
ひていじょうりゅう	非定常流	名詞
ひとうほう	非等方	名詞
ひとうほうせい	非等方性	名詞
ひとうほうてき	非等方的	名詞
ぴとー	ピトー	名詞
ぴとーかん	ピトー管	名詞
ひどらじん	ヒドラジン	名詞
ひにんしょう	非人称	名詞
ひにんしょうどうし	非人称動詞	名詞
ひねんせいりゅう	非粘性流	名詞
ひねんせいりゅうたい	非粘性流体	名詞
ひはかい	非破壊	名詞
ひふ	非負	名詞
ひふぎょうれつ	非負行列	名詞
ひふくそう	被覆層	名詞
ひふべくとる	非負ベクトル	名詞
びぶんいちけいしき	微分1形式	名詞
びぶんかのう	微分可能	名詞
びぶんかのうせい	微分可能性	名詞
びぶんかのうたようたい	微分可能多様体	名詞
びぶんきか	微分幾何	名詞
びぶんけいしき	微分形式	名詞
びぶんけいすう	微分係数	名詞
びぶんこうぞう	微分構造	名詞
びぶんさようそ	微分作用素	名詞
びぶんさんけいしき	微分3形式	名詞
びぶんぜろけいしき	微分0形式	名詞
びぶんどうてきけいかくほう	微分動的計画法	名詞
びぶんにけいしき	微分2形式	名詞
びぶんほうていしき	微分方程式	名詞
びぶんほうていしき	微分方程式	名詞
びぶんほうていしきけい	微分方程式系	名詞
ひぶんりかくだい	非分離拡大	名詞
ひぶんりてき	非分離的	名詞
ひほろのみっく	非ホロノミック	名詞
ひめいぶん	碑銘文	名詞
ひゅーい	ヒューイ	名詞
ひゅーいしゃ	ヒューイ社	名詞
ひゅーずしゃ	ヒューズ社	名詞
ひょうしき	表式	名詞
ひょうじゅんせい	標準性	名詞
ひょうすう	標数	名詞
ひょうそうざい	表層材	名詞
ひょうそうぶ	表層部	名詞
ひょうちゃく	氷着	名詞
ひらーしゃ	ヒラー社	名詞
ひれい	非零	名詞
ひれいかい	非零解	名詞
ひろうはかい	疲労破壊	名詞
ひろうはかい	疲労破壊	名詞
ひろうふか	疲労負荷	名詞
ひろろのみっく	非ホロノミック	名詞
びんかんせい	敏感性	名詞
ひんじおふせっと	ヒンジ・オフセット	名詞
ひんじれす	ヒンジレス	名詞
ひんじれすはぶ	ヒンジレス・ハブ	名詞
ひんじれすろーたー	ヒンジレス・ローター	名詞
ふぁらっど	F	名詞
ふぁらっど	F	名詞
ふあんていかい	不安定解	名詞
ふあんていてん	不安定点	名詞
ふぃぎゅあおぶめりっと	フィギュア・オブ・メリット	名詞
ふぃらめんとじょう	フィラメント状	名詞
ふうこうけい	風向計	名詞
ふうどうじっけん	風洞実験	名詞
ぷーりー	プーリー	名詞
ふーりえきゅうすう	フーリエ級数	名詞
ふーりえけいすう	フーリエ係数	名詞
ぶーるだいすう	ブール代数	名詞
ふぇざーかく	フェザー角	名詞
ふぇざりんぐじく	フェザリング軸	名詞
ふぇねすとろん	フェネストロン	名詞
ふぇらいとけい	フェライト系	名詞
ふぇらいとりょう	フェライト量	名詞
ふかご	付加語	名詞
ふかさんめいし	不可算名詞	名詞
ふかしき	負荷式	名詞
ふかひ	不可避	名詞
ふかひてき	不可避的	名詞
ふかんぜんがんまかんすう	不完全ガンマ関数	名詞
ふかんぜんねんしょう	不完全燃焼	名詞
ふきおろし	吹き下ろし	名詞
ふきおろしりゅう	吹き降ろし流	名詞
ふきすう	負奇数	名詞
ふきんいつせい	不均一性	名詞
ふぐうすう	負偶数	名詞
ふくかく	伏角	名詞
ふくざ	複座	名詞
ふくそかんすう	複素関数	名詞
ふくそきょうえき	複素共役	名詞
ふくそきょうやく	複素共役	名詞
ふくそくうかん	複素空間	名詞
ふくそすうたい	複素数体	名詞
ふくそすうれつ	複素数列	名詞
ふくそせきぶん	複素積分	名詞
ふくそせんけい	複素線形	名詞
ふくそせんけいくうかん	複素線形空間	名詞
ふくそそくど	複素速度	名詞
ふくそへいめん	複素平面	名詞
ふくそべくとる	複素ベクトル	名詞
ふくそぽてんしゃる	複素ポテンシャル	名詞
ふくたい	複体	名詞
ふくにじほうていしき	複二次方程式	名詞
ふくりゅう	複流	名詞
ふじゅんぶつりょう	不純物量	名詞
ふしょうふめつ	不生不滅	名詞
ふしんとう	不浸透	名詞
ふせいすう	負整数	名詞
ふせいち	不整地	名詞
ふせいちちゃくりく	不整地着陸	名詞
ぶつりのかぎしっぽ	http://www12.plala.or.jp/ksp/	固有名詞
ぶつりのかぎしっぽ	物理のかぎしっぽ	固有名詞
ふていせきぶん	不定積分	名詞
ふどうてん	不動点	名詞
ぶどまり	歩留	名詞
ぷとれまいおす	プトレマイオス	名詞
ぶぶんかん	部分環	名詞
ぶぶんしゅうごう	部分集合	名詞
ぶぶんしゅうごうぞく	部分集合族	名詞
ぶぶんせきぶん	部分積分	名詞
ぶぶんたい	部分体	名詞
ぶぶんたようたい	部分多様体	名詞
ぶぶんは	部分波	名詞
ぶぶんわ	部分和	名詞
ふへんぶぶんくうかん	不変部分空間	名詞
ふへんりょう	不変量	名詞
ふらいばいわいや	フライ・バイ・ワイヤ	名詞
ぶらけっとけいれつ	ブラケット系列	名詞
ぶらしうす	ブラシウス	名詞
ふらっぴんぐ	フラッピング	名詞
ふらっぴんぐひんじ	フラッピング・ヒンジ	名詞
ふらっぷあっぷ	フラップ・アップ	名詞
ふらっぷかく	フラップ角	名詞
ぷらんどる	プランドル	名詞
ぷらんどるすう	プランドル数	名詞
ふりてん	不利点	名詞
ふれあじ	フレア時	名詞
ぶれーどか	ブレード渦	名詞
ぶれーどかじゅう	ブレード荷重	名詞
ぶれーどけい	ブレード系	名詞
ぶれーどたん	ブレード端	名詞
ふれかく	振れ角	名詞
ふれしぇ	フレシェ	名詞
ふれっくすびーむ	フレックス＝ビーム	名詞
ふれねる	フレネル	名詞
ふれんぞくてん	不連続点	名詞
ふれんぞくなかんすう	不連続な関数	名詞
ふろけ	フロケ	名詞
ふろべにうす	フロベニウス	名詞
ぷろぺらこうりゅう	プロペラ後流	名詞
ぶんかい	分塊	名詞
ぶんかいたい	分解体	名詞
ぶんきかい	分岐解	名詞
ぶんきず	分岐図	名詞
ぶんしこうぶん	分詞構文	名詞
ぶんすうたい	分数体	名詞
ぶんせきき	分析器	名詞
ぶんせきち	分析値	名詞
ぶんぱいそく	分配則	名詞
ぶんぱいりつ	分配律	名詞
ぶんぱいりつ	分配率	名詞
ぶんぷかんすう	分布関数	名詞
ふんむこう	噴霧口	名詞
ぶんりかくだい	分離拡大	名詞
ぶんりこうり	分離公理	名詞
ぶんりていすう	分離定数	名詞
ぶんりてき	分離的	名詞
ぶんりてん	分離点	名詞
ぶんりりゅうせん	分離流線	名詞
ぺあの	ペアノ	名詞
ぺあのきょくせん	ペアノ曲線	名詞
へいえんばん	閉円板	名詞
へいかいろ	閉回路	名詞
へいきょくめん	閉曲面	名詞
へいきんじゆうこうてい	平均自由行程	名詞
へいきんぶんしこうてい	平均分子行程	名詞
へいきんぼう	閉近傍	名詞
へいきんよくげんちょう	平均翼弦長	名詞
へいくかん	閉区間	名詞
へいけいしき	閉形式	名詞
へいこううずれつ	平行渦列	名詞
へいこうじょうたい	平衡状態	名詞
へいこうすい	平衡錘	名詞
へいこうてん	平衡点	名詞
へいこうほうていしき	平衡方程式	名詞
ぺいさー	ペイサー	名詞
ぺいさーしすてむ	ペイサーシステム	名詞
へいしゅうごう	閉集合	名詞
へいしゅうごうけい	閉集合系	名詞
へいじよう	平時用	名詞
へいしんうんどう	並進運動	名詞
へいしんそくど	並進速度	名詞
へいしんよく	並進速度	名詞
へいたい	閉体	名詞
へいほう	閉包	名詞
へいほうさようそ	閉包作用素	名詞
へいめんしんこうは	平面進行波	名詞
へいめんは	平面波	名詞
へいめんへき	平面壁	名詞
べーたかんすう	ベータ関数	名詞
べーないと	ベーナイト	名詞
へきかい	劈開	名詞
べきかんすう	冪関数	名詞
べききゅうすう	冪級数	名詞
べきこん	冪根	名詞
べきこんかんすう	冪根関数	名詞
べきじょう	冪乗	名詞
べきじょうこん	冪乗根	名詞
へきめんきょうかい	壁面境界	名詞
べきれい	冪零	名詞
べきれいぎょうれつ	冪零行列	名詞
べきれいへんかん	冪零変換	名詞
べくとるくうかん	ベクトル空間	名詞
べくとるば	ベクトル場	名詞
べっかい	別解	名詞
べっせるかんすう	ベッセル関数	名詞
べるしゃ	ベル社	名詞
べるとらみ	ベルトラミ	名詞
へんか	変化	名詞
へんかりつ	変化率	名詞
へんかんき	変換器	名詞
へんかんぐん	変換群	名詞
へんかんしき	変換式	名詞
へんかんそく	変換則	名詞
へんきゅうめん	偏球面	名詞
へんきゅうめんざひょう	偏球面座標	名詞
へんきょくてん	変曲点	名詞
へんけいいき	変形域	名詞
へんけいきょどう	変形挙動	名詞
へんけいひ	変形比	名詞
へんけいりょう	変形量	名詞
へんこうよく	偏向翼	名詞
へんすうぶんりけい	変数分離型	名詞
へんすうぶんりけい	変数分離形	名詞
へんすうへんかん	変数変換	名詞
へんせき	偏析	名詞
へんたいひこう	編隊飛行	名詞
へんだえんたい	偏楕円体	名詞
べんど	ベンド	名詞
へんどうかんすう	偏導関数	名詞
へんびぶん	偏微分	名詞
へんびぶんほうていしき	偏微分方程式	名詞
へんぶんほう	変分法	名詞
へんへん	辺々	名詞
へんりー	H	名詞
ぽあそん	ポアソン	名詞
ぽあそんかっこ	ポアソン括弧	名詞
ぽあんかれ	ポアンカレ	名詞
ぼいど	ボイド	名詞
ほいへんすは	ホイヘンス波	名詞
ほういかく	方位角	名詞
ほうこうあんてい	方向安定	名詞
ほうこうあんていせい	方向安定性	名詞
ほうこうぞく	芳香族	名詞
ほうこうだ	方向舵	名詞
ほうこうびぶん	方向微分	名詞
ほうこうよげん	方向余弦	名詞
ほうしょう	方晶	名詞
ほうせき	包迹	名詞
ぼうせつ	防雪	名詞
ほうせんおうりょく	法線応力	名詞
ほうせんせいぶん	法線成分	名詞
ぼうちょうは	膨張波	名詞
ほうていしきけい	方程式系	名詞
ぼうひょう	防氷	名詞
ほうぶつ	放物	名詞
ほうぶつうんどう	放物運動	名詞
ほうぶつちゅう	放物柱	名詞
ほうぶつめん	放物面	名詞
ほうべくとる	法ベクトル	名詞
ほうらく	包絡	名詞
ほうらくせん	包絡線	名詞
ほうらくめん	包絡面	名詞
ほうれい	放冷	名詞
ぼーいんぐばーとる	ボーイングバートル	名詞
ぼーいんぐばーとるしゃ	ボーイング・バートル社	名詞
ほかくだんめんせき	捕獲断面積	名詞
ほかん	補完	名詞
ぼかんすう	母関数	名詞
ぼざい	母材	名詞
ほしゅうき	捕集器	名詞
ほじょけた	補助桁	名詞
ほじろ	保持炉	名詞
ほせいけいすう	補正係数	名詞
ほぞんりょう	保存量	名詞
ほぞんりょく	保存力	名詞
ほだい	補題	名詞
ほっじ	ホッジ	名詞
ほっじえんざんし	ホッジ演算子	名詞
ほっじきごう	ホッジ記号	名詞
ぽてんしゃるりゅう	ポテンシャル流	名詞
ほばりんぐじ	ホバリング時	名詞
ほばりんぐせんかい	ホバリング旋回	名詞
ほもろじー	ホモロジー	名詞
ぽりがんま	ポリガンマ	名詞
ぽりがんまかんすう	ポリガンマ関数	名詞
ぼるつまん	ボルツマン	名詞
ぼると	V	名詞
ぼるとざい	ボルト材	名詞
ほろのみっく	ホロノミック	名詞
ぼろん	ボロン	名詞
ほんかいはつ	本開発	名詞
ほんけんきゅう	本研究	名詞
ほんほうこくしょ	本報告書	名詞
ほんもん	本問	名詞
まいかいてん	毎回転	名詞
まいくろがす	マイクロガス	名詞
まいくろは	マイクロ波	名詞
まがりいた	曲板	名詞
まくすうぇる	マクスウェル	名詞
まくだねるだぐらす	マクダネル/ダグラス	名詞
まくだねるだぐらすしゃ	マクダネル/ダグラス社	名詞
まくろーりんてんかい	マクローリン展開	名詞
まくろだんめんせき	マクロ断面積	名詞
まさつこうりょく	摩擦抗力	名詞
ますとばんぴんぐ	マスト・バンピング	名詞
または	∪	名詞
まっくすうぇる	マックスウェル	名詞
まっくすうぇるほうていしき	マックスウェル方程式	名詞
まにゅあるか	マニュアル化	名詞
まにゅぴゅれーた	マニュピュレータ	名詞
まもう	摩耗	名詞
まもうせい	摩耗性	名詞
まるえーじんぐ	マルエージング	名詞
まるてんさいと	マルテンサイト	名詞
まるてんさいとか	マルテンサイト化	名詞
まるてんさいとけい	マルテンサイト系	名詞
まるてんさいとりょう	マルテンサイト量	名詞
まんじかんじゃく	万時間弱	名詞
みぃーてぃんぐ	ミィーティング	名詞
みぎきょくげん	右極限	名詞
みぎてけい	右手系	名詞
みぎれいいんし	右零因子	名詞
みくろだんめんせき	ミクロ断面積	名詞
みこよう	未固溶	名詞
みすとぶらすと	ミストブラスト	名詞
みずもれ	水もれ	名詞
みちていすう	未知定数	名詞
みちへんすう	未知変数	名詞
みっちゃくいそう	密着位相	名詞
みつどひ	密度比	名詞
みっぺいくごう	密閉空盒	名詞
みていじょうすうほう	未定乗数法	名詞
みなおしご	見直し後	名詞
みなおしぶん	見直し分	名詞
みょんどん	明洞	名詞
みらいぶんし	未来分詞	名詞
みる	ミル	名詞
みるしーと	ミルシート	名詞
むかえかく	迎角	名詞
むかんし	無冠詞	名詞
むげんえん	無限遠	名詞
むげんえんてん	無限遠点	名詞
むげんかい	無限回	名詞
むげんかいびぶん	無限回微分	名詞
むげんきゅうすう	無限級数	名詞
むげんぐん	無限群	名詞
むげんこ	無限個	名詞
むげんじ	無限次	名詞
むげんじかくだい	無限次拡大	名詞
むげんしゅうごう	無限集合	名詞
むげんしょう	無限小	名詞
むげんしょうかいてん	無限小回転	名詞
むげんじょうせき	無限乗積	名詞
むげんしょうへんかん	無限小変換	名詞
むげんたい	無限体	名詞
むげんだい	∞大	名詞
むげんまい	無限枚	名詞
むげんわ	無限和	名詞
むじげん	無次元	名詞
むじげんか	無次元化	名詞
むじげんすう	無次元数	名詞
むじげんぱらめーたー	無次元パラメーター	名詞
むそうか	夢想家	名詞
むびよく	無尾翼	名詞
むびよくき	無尾翼機	名詞
むへんか	無変化	名詞
むりかんすう	無理関数	名詞
むれいきゃく	無冷却	名詞
めいさいとそう	迷彩塗装	名詞
めいんろーたー	メインローター	名詞
めーとる	m	名詞
めかにかるあろい	メカニカルアロイ	名詞
めちるき	メチル基	名詞
めびうすのわ	メビウスの輪	名詞
めるてぃんぐほう	メルティング法	名詞
めんあつ	面圧	名詞
めんぐん	面群	名詞
めんしん	面心	名詞
めんしん	面心	名詞
めんしんりっぽうこうし	面心立方格子	名詞
めんせきそ	面積素	名詞
めんせきぶん	面積分	名詞
めんせきようそ	面積要素	名詞
めんたいしょう	面対称	名詞
めんみつど	面密度	名詞
めんようそ	面要素	名詞
もーぺるてゅい	モーペルテュイ	名詞
もけいよう	模型用	名詞
もとゆみ	元弓	名詞
ものいど	モノイド	名詞
もるすう	モル数	名詞
やきいれ	焼入れ	名詞
やきいれざい	焼入れ材	名詞
やきいれじ	焼入れ時	名詞
やきいれせい	焼入れ性	名詞
やきつき	焼付	名詞
やきつきせい	焼付性	名詞
やきならし	焼ならし	名詞
やきもどし	焼もどし	名詞
やきもどしご	焼もどし後	名詞
やきもどしざい	焼もどし材	名詞
やきもどした	焼もどした	名詞
やきもどしなんか	焼もどし軟化	名詞
やく	ヤク	名詞
やこび	ヤコビ	名詞
やこぶれふ	ヤコブレフ	名詞
やだか	矢高	名詞
やんぐりつ	ヤング率	名詞
ゆあつきこう	油圧機構	名詞
ゆあつけい	油圧計	名詞
ゆあつべん	油圧弁	名詞
ゆういさ	有意差	名詞
ゆうかい	有界	名詞
ゆうがいこうりょく	有害抗力	名詞
ゆうき	誘起	名詞
ゆうきそくど	誘起速度	名詞
ゆうきそくどぶんぷ	誘起速度分布	名詞
ゆうきながれ	誘起流れ	名詞
ゆうきばりき	誘起馬力	名詞
ゆうきりゅう	誘起流	名詞
ゆーくりっどくうかん	ユークリッド空間	名詞
ゆうげんかい	有限回	名詞
ゆうげんぐん	有限群	名詞
ゆうげんこう	有限項	名詞
ゆうげんじ	有限次	名詞
ゆうげんじかくだい	有限次拡大	名詞
ゆうげんじげん	有限次元	名詞
ゆうげんしゅうごう	有限集合	名詞
ゆうげんせいせい	有限生成	名詞
ゆうげんたい	有限体	名詞
ゆうげんてん	有限点	名詞
ゆうげんまい	有限枚	名詞
ゆうげんわ	有限和	名詞
ゆうこう	有向	名詞
ゆうこうせきぶん	有向積分	名詞
ゆうこうせんぶん	有向線分	名詞
ゆうこうちょっけい	有効直径	名詞
ゆうこうてんれつ	有向点列	名詞
ゆうじげん	有次元	名詞
ゆうせいはぐるま	遊星歯車	名詞
ゆうでんりつ	誘電率	名詞
ゆうどうこうりょく	誘導抗力	名詞
ゆうどうていこう	誘導抵抗	名詞
ゆうどうとう	誘導灯	名詞
ゆうどうみさいる	誘導ミサイル	名詞
ゆうりかんすう	有理関数	名詞
ゆうりかんすうたい	有理関数体	名詞
ゆうりけい	有理型	名詞
ゆうりすうたい	有理数体	名詞
ゆうりせいすう	有理整数	名詞
ゆくて	行く手	名詞
ゆながれ	湯流れ	名詞
ゆながれせい	湯流れ性	名詞
ゆにたり	ユニタリ	名詞
ゆにたりーぐん	ユニタリー群	名詞
ゆにたりぎょうれつ	ユニタリ行列	名詞
ゆにたりくうかん	ユニタリ空間	名詞
ゆにたりぐん	ユニタリ群	名詞
ゆびづかい	指遣い	名詞
ゆみさき	弓先	名詞
ゆみりょう	弓量	名詞
ゆれい	油冷	名詞
ゆれい	湯冷	名詞
よいんし	余因子	名詞
よいんしぎょうれつ	余因子行列	名詞
よう	溶	名詞
ようかいじ	溶解時	名詞
ようかいそう	溶解層	名詞
ようかいそうち	溶解装置	名詞
ようかいりょう	溶解量	名詞
ようかくにん	要確認	名詞
ようかけ	用掛け	名詞
ようかとう	溶加棟	名詞
ようかんすう	陽関数	名詞
ようきゅうち	要求値	名詞
ようきん	溶金	名詞
ようけん	溶研	名詞
ようこう	溶鋼	名詞
ようこうひ	揚抗比	名詞
ようざい	溶材	名詞
ようしゃ	溶射	名詞
ようすいよう	揚水用	名詞
ようせい	溶製	名詞
ようせいし	溶製し	名詞
ようせつご	溶接後	名詞
ようせつしけん	溶接試験	名詞
ようせつせい	溶接性	名詞
ようせつにくもり	溶接肉盛	名詞
ようせつりょう	溶接量	名詞
ようせん	溶銑	名詞
ようぞん	溶損	名詞
ようたいか	溶体化	名詞
ようとう	溶湯	名詞
ようどう	揺動	名詞
ようとうちゅう	溶湯中	名詞
ようとうりょう	溶湯量	名詞
ようなしがた	洋梨形	名詞
ようりょうしょ	要領書	名詞
ようりょくけいすう	揚力係数	名詞
ようりょくさ	揚力差	名詞
ようりょくせん	揚力線	名詞
ようりょくせんきんじ	揚力線近似	名詞
よかく	与格	名詞
よくあつ	翼厚	名詞
よくあつひ	翼厚比	名詞
よくがた	翼型	名詞
よくげん	翼弦	名詞
よくげんちょう	翼弦長	名詞
よくこん	翼根	名詞
よくこんぶ	翼根部	名詞
よくざい	翼材	名詞
よくしんどう	翼振動	名詞
よくせいぞう	翼製造	名詞
よくそ	翼素	名詞
よくそりろん	翼素理論	名詞
よくたん	翼端	名詞
よくたんか	翼端渦	名詞
よくはば	翼幅	名詞
よくひょうめん	翼表面	名詞
よくめん	翼面	名詞
よくめんかじゅう	翼面荷重	名詞
よくめんせき	翼面積	名詞
よくめんばりき	翼面馬力	名詞
よくりろん	翼理論	名詞
よげんかんすう	余弦関数	名詞
よげんていり	余弦定理	名詞
よげんぶ	余弦部	名詞
よこあんてい	横安定	名詞
よこすべりかく	横滑り角	名詞
よこべくとる	横ベクトル	名詞
よしき	与式	名詞
よせつ	余接	名詞
よせつべくとる	余接ベクトル	名詞
よせつべくとるば	余接ベクトル場	名詞
よどみてん	淀み点	名詞
よにく	余肉	名詞
よねつき	予熱器	名詞
よやくひょう	予約票	名詞
よゆうばりき	余裕馬力	名詞
よんか	四価	名詞
よんかく	4格	名詞
よんしょう	四翔	名詞
よんちょうてん	四頂点	名詞
よんちょうてんていり	四頂点定理	名詞
よんりんしき	四輪式	名詞
らーべす	ラーベス	名詞
らーべすそう	ラーベス相	名詞
らいかみんぐ	ライカミング	名詞
らいぷにっつ	ライプニッツ	名詞
らいまんけいれつ	ライマン系列	名詞
らぎんぐ	ラギング	名詞
らぐかく	ラグ角	名詞
らぐひんじ	ラグヒンジ	名詞
らぐほうていしき	ラグ方程式	名詞
らぐらんじあん	ラグランジアン	名詞
らぐらんじぇ	ラグランジェ	名詞
らげーる	ラゲール	名詞
らせんかく	螺旋角	名詞
らせんけい	螺旋形	名詞
らせんふあんてい	螺旋不安定	名詞
らせんめん	螺旋面	名詞
らてんほうじん	ラテン方陣	名詞
らぷちゃー	ラプチャー	名詞
らぷらしあん	ラプラシアン	名詞
らぷらすほうていしき	ラプラス方程式	名詞
らまぬじゃん	ラマヌジャン	名詞
らめら	ラメラ	名詞
らんきん	ランキン	名詞
らんぐれー	ラングレー	名詞
らんぐれーぶ	ラングレーブ	名詞
らんりゅうかいせき	乱流解析	名詞
りあぷのふ	リアプノフ	名詞
りあぷのふしゅみっと	リアプノフ＝シュミット	名詞
りあぷのふしゅみっとほう	リアプノフ＝シュミット法	名詞
りーく	リーク	名詞
りーぐん	リー群	名詞
りーだいすう	リー代数	名詞
りーどらぐ	リード・ラグ	名詞
りーどらぐだんぱー	リード・ラグ・ダンパー	名詞
りーどらぐひんじ	リード・ラグ・ヒンジ	名詞
りーまん	リーマン	名詞
りーまんきか	リーマン幾何	名詞
りーまんきかがく	リーマン幾何学	名詞
りーまんきゅうめん	リーマン球面	名詞
りーまんけいりょう	リーマン計量	名詞
りーまんめん	リーマン面	名詞
りきがくしゃ	力学者	名詞
りきせき	力積	名詞
りくぐんき	陸軍機	名詞
りさんいそう	離散位相	名詞
りさんうず	離散渦	名詞
りさんうずほう	離散渦法	名詞
りさんか	離散化	名詞
りさんがたけいかくほう	離散型計画法	名詞
りさんかほう	離散化法	名詞
りさんかんすう	離散関数	名詞
りさんぎゃくふーりえへんかん	離散逆フーリエ変換	名詞
りさんけいすう	離散係数	名詞
りさんこうし	離散格子	名詞
りさんこさいんへんかん	離散コサイン変換	名詞
りさんどうてきけいかくほう	離散動的計画法	名詞
りじっとろーたー	リジット・ローター	名詞
りしょうしゅつりょく	離昇出力	名詞
りだつうず	離脱渦	名詞
りっしき	立式	名詞
りっそく	律速	名詞
りっそく	律速	名詞
りったいかく	立体角	名詞
りったいしゃえい	立体射影	名詞
りっと	リット	名詞
りっとる	l	名詞
りはっちゃく	離発着	名詞
りふらくとあろい	リフラクトアロイ	名詞
りむど	リムド	名詞
りゃくし	略史	名詞
りゅう	硫	名詞
りゅうかい	粒界	名詞
りゅうかいはめん	粒界破面	名詞
りゅうかん	流管	名詞
りゅうしゅつ	留出	名詞
りゅうすう	留数	名詞
りゅうすうていり	留数定理	名詞
りゅうせん	流線	名詞
りゅうせんぐん	流線群	名詞
りゅうせんけいか	流線形化	名詞
りゅうそく	流束	名詞
りゅうたいうんどう	流体運動	名詞
りゅうたいちゅう	流体中	名詞
りゅうたいない	流体内	名詞
りゅうたいようそ	流体要素	名詞
りゅうたいりょういき	流体領域	名詞
りゅうど	粒度	名詞
りゅーどべりじょうすう	リュードベリ定数	名詞
りゅうにゅうかく	流入角	名詞
りゅうにゅうりつ	流入率	名詞
りゅうにゅうりゅう	流入流	名詞
りゅーびる	リュービル	名詞
りゅうろ	流路	名詞
りょうきしゅみ	猟奇趣味	名詞
りょうさんき	量産機	名詞
りょうしけん	両試験	名詞
りょうひ	量比	名詞
りりくさいだいしゅつりょく	離陸最大出力	名詞
りんかいまっはすう	臨界マッハ数	名詞
りんかいれいのるずすう	臨界レイノルズ数	名詞
りんこう	輪講	名詞
りんこうかい	輪講会	名詞
るいたい	類体	名詞
るいたいろん	類体論	名詞
るーとかっと	ルートカット	名詞
るーめん	lm	名詞
るじゃんどる	ルジャンドル	名詞
るじゃんどるへんかん	ルジャンドル変換	名詞
るばーと	ルバート	名詞
れい	冷	名詞
れいいんし	零因子	名詞
れいえん	冷延	名詞
れいかい	零解	名詞
れいかん	零環	名詞
れいかん	冷間	名詞
れいきし	励起子	名詞
れいぎょうれつ	零行列	名詞
れいげん	零元	名詞
れいそく	冷速	名詞
れいだー	レイダー	名詞
れいだーす	レイダース	名詞
れいたい	冷態	名詞
れいたつ	令達	名詞
れいのるず	レイノルズ	名詞
れいのるずすう	レイノルズ数	名詞
れいのるずすう	レイノルズ数	名詞
れいりー	レイリー	名詞
れいりつ	捩率	名詞
れーどる	レードル	名詞
れしぷろ	レシプロ	名詞
れじん	レジン	名詞
れつべくとる	列ベクトル	名詞
れぷりかほう	レプリカ法	名詞
れんけつせい	連結性	名詞
れんげん	連言	名詞
れんせい	連成	名詞
れんせつかん	連接桿	名詞
れんぞくかんすう	連続関数	名詞
れんぞくきょくせん	連続曲線	名詞
れんぞくぐん	連続群	名詞
れんぞくさいだいしゅつりょく	連続最大出力	名詞
れんぞくしゃぞう	連続写像	名詞
れんぞくせい	連続性	名詞
れんぞくなかんすう	連続な関数	名詞
れんぞくのしき	連続の式	名詞
れんぞくびぶんかのう	連続微分可能	名詞
れんぞくりょういき	連続領域	名詞
ろう	ロウ	名詞
ろう	ろう	名詞
ろうざい	ろう材	名詞
ろうづけ	ロウ付け	名詞
ろうづけ	ろう付け	名詞
ろうでんしゃだんき	漏電遮断器	名詞
ろーた	ロータ	名詞
ろーたーかじゅう	ローター荷重	名詞
ろーたーしゃふと	ローターシャフト	名詞
ろーたーすいりょく	ローター推力	名詞
ろーたざい	ロータ材	名詞
ろーたざいしつ	ロータ材質	名詞
ろーたしよう	ロータ仕様	名詞
ろーどふぁくたー	ロードファクター	名詞
ろーらんてんかい	ローラン展開	名詞
ろーりんぐ	ローリング	名詞
ろーるかん	ロール間	名詞
ろーれんつぐん	ローレンツ群	名詞
ろかき	濾過器	名詞
ろくしょう	六翔	名詞
ろくぼうせい	六芒星	名詞
ろっか	六価	名詞
ろっきーどしゃ	ロッキード社	名詞
ろっくすう	ロック数	名詞
ろっとざい	ロット材	名詞
ろどりぐ	ロドリグ	名詞
ろぴたる	ロピタル	名詞
ろんすきあん	ロンスキアン	名詞
ろんすきー	ロンスキー	名詞
ろんすきーぎょうれつ	ロンスキー行列	名詞
ろんよりしょうこ	論より証拠	名詞
わーるたわー	ワールタワー	名詞
わいたいしょうぎょうれつ	歪対称行列	名詞
わくうかん	和空間	名詞
わしゅうごう	和集合	名詞
わせき	和積	名詞
わっと	W	名詞
んがた	n形	名詞
